UF,Município,Masculino,Feminino,Não Informado,Total
AC,Acrelândia,99,87,10,196
AC,Assis Brasil,267,288,11,566
AC,Brasiléia,422,336,33,791
AC,Bujari,16,3,0,19
AC,Capixaba,7,3,0,10
AC,Cruzeiro do Sul,1206,1370,9,2585
AC,Epitaciolândia,15,6,0,21
AC,Feijó,342,289,14,645
AC,Jordão,2,2,0,4
AC,Mâncio Lima,1042,1171,50,2263
AC,Manoel Urbano,117,98,18,233
AC,Marechal Thaumaturgo,414,261,11,686
AC,Plácido de Castro,181,99,7,287
AC,Porto Acre,254,142,14,410
AC,Porto Walter,286,271,29,586
AC,Rio Branco,1411,843,23,2277
AC,Rodrigues Alves,850,807,39,1696
AC,Santa Rosa do Purus,1,0,0,1
AC,Senador Guiomard,9,8,1,18
AC,Sena Madureira,743,587,39,1369
AC,Tarauacá,177,124,14,315
AC,Xapuri,1,0,0,1
AL,Arapiraca,4,0,0,4
AL,Barra de Santo Antônio,103,63,6,172
AL,Barra de São Miguel,11,9,0,20
AL,Belo Monte,265,269,3,537
AL,Campo Grande,1,0,0,1
AL,Carneiros,4,3,0,7
AL,Coité do Nóia,1,0,0,1
AL,Coqueiro Seco,101,192,1,294
AL,Coruripe,440,704,9,1153
AL,Delmiro Gouveia,101,39,0,140
AL,Feliz Deserto,85,204,0,289
AL,Igaci,29,4,0,33
AL,Igreja Nova,793,1224,12,2029
AL,Japaratinga,242,482,3,727
AL,Jaramataia,126,117,0,243
AL,Jequiá da Praia,100,66,0,166
AL,Joaquim Gomes,0,1,0,1
AL,Jundiá,1,0,0,1
AL,Maceió,4644,5509,9,10162
AL,Maragogi,778,1702,3,2483
AL,Maravilha,75,103,7,185
AL,Marechal Deodoro,266,381,1,648
AL,Murici,1,1,0,2
AL,Olho d`Água das Flores,0,2,0,2
AL,Olho d`Água do Casado,3,0,0,3
AL,Olho d`Água Grande,5,12,1,18
AL,Palmeira dos Índios,4,0,1,5
AL,Pão de Açúcar,120,109,1,230
AL,Pariconha,1,0,0,1
AL,Paripueira,97,139,4,240
AL,Passo de Camaragibe,180,71,0,251
AL,Penedo,449,631,1,1081
AL,Piaçabuçu,525,641,13,1179
AL,Pilar,147,102,1,250
AL,Piranhas,191,188,1,380
AL,Poço das Trincheiras,0,2,0,2
AL,Porto Calvo,2,1,0,3
AL,Porto de Pedras,64,78,0,142
AL,Porto Real do Colégio,388,630,38,1056
AL,Quebrangulo,2,0,0,2
AL,Rio Largo,1,0,0,1
AL,Roteiro,127,269,7,403
AL,Santa Luzia do Norte,28,46,0,74
AL,Santana do Mundaú,0,1,0,1
AL,São Brás,153,233,8,394
AL,São José da Tapera,1,2,0,3
AL,São Miguel dos Campos,5,4,0,9
AL,São Miguel dos Milagres,71,21,2,94
AL,São Sebastião,0,6,0,6
AL,Satuba,3,2,0,5
AL,Senador Rui Palmeira,1,0,0,1
AL,Traipu,276,135,2,413
AM,Alvarães,98,87,1,186
AM,Amaturá,117,69,0,186
AM,Anamã,483,412,8,903
AM,Anori,1124,810,4,1938
AM,Apuí,88,81,1,170
AM,Atalaia do Norte,252,253,0,505
AM,Autazes,1531,1255,23,2809
AM,Barcelos,333,131,0,464
AM,Barreirinha,348,148,1,497
AM,Benjamin Constant,1683,908,0,2591
AM,Beruri,1066,662,1,1729
AM,Boa Vista do Ramos,140,66,1,207
AM,Boca do Acre,492,276,4,772
AM,Borba,1262,962,6,2230
AM,Caapiranga,372,291,2,665
AM,Canutama,612,419,1,1032
AM,Carauari,205,87,1,293
AM,Careiro,2963,1900,3,4866
AM,Careiro da Várzea,542,458,11,1011
AM,Coari,1927,1115,24,3066
AM,Codajás,453,409,5,867
AM,Eirunepé,266,204,3,473
AM,Envira,366,164,2,532
AM,Fonte Boa,1896,1018,22,2936
AM,Guajará,123,44,0,167
AM,Humaitá,92,54,1,147
AM,Ipixuna,689,475,0,1164
AM,Iranduba,1242,801,5,2048
AM,Itacoatiara,2961,2137,9,5107
AM,Itamarati,107,64,0,171
AM,Itapiranga,396,444,33,873
AM,Japurá,57,39,0,96
AM,Juruá,325,230,5,560
AM,Jutaí,547,522,8,1077
AM,Lábrea,261,197,13,471
AM,Manacapuru,5128,3592,32,8752
AM,Manaquiri,799,389,1,1189
AM,Manaus,16997,9391,9,26397
AM,Manicoré,404,357,6,767
AM,Maraã,200,128,1,329
AM,Maués,149,62,3,214
AM,Nhamundá,143,55,0,198
AM,Nova Olinda do Norte,317,147,4,468
AM,Novo Airão,187,145,1,333
AM,Novo Aripuanã,185,120,8,313
AM,Parintins,1485,243,4,1732
AM,Pauini,302,146,1,449
AM,Presidente Figueiredo,134,71,6,211
AM,Rio Preto da Eva,188,119,3,310
AM,Santa Isabel do Rio Negro,232,192,2,426
AM,Santo Antônio do Içá,235,321,15,571
AM,São Gabriel da Cachoeira,15,15,0,30
AM,São Paulo de Olivença,391,505,4,900
AM,São Sebastião do Uatumã,83,56,0,139
AM,Silves,204,131,4,339
AM,Tabatinga,611,338,2,951
AM,Tapauá,752,706,8,1466
AM,Tefé,653,518,4,1175
AM,Tonantins,571,561,1,1133
AM,Uarini,379,264,7,650
AM,Urucará,220,105,0,325
AM,Urucurituba,1222,749,12,1983
AP,Amapá,456,360,12,828
AP,Calçoene,182,48,8,238
AP,Cutias,64,50,1,115
AP,Ferreira Gomes,80,133,2,215
AP,Itaubal,113,73,6,192
AP,Laranjal do Jari,359,251,5,615
AP,Macapá,3429,2720,47,6196
AP,Mazagão,269,265,7,541
AP,Oiapoque,244,65,7,316
AP,Pedra Branca do Amapari,51,45,9,105
AP,Porto Grande,88,108,2,198
AP,Pracuúba,152,102,2,256
AP,Santana,3414,3350,49,6813
AP,Serra do Navio,8,11,1,20
AP,Tartarugalzinho,373,493,14,880
AP,Vitória do Jari,134,223,1,358
BA,Abaré,89,88,2,179
BA,Acajutiba,1,0,0,1
BA,Adustina,55,4,0,59
BA,Alagoinhas,0,1,0,1
BA,Alcobaça,384,520,5,909
BA,Almadina,0,1,0,1
BA,Amélia Rodrigues,1,0,0,1
BA,Anagé,11,0,0,11
BA,Andorinha,25,21,0,46
BA,Angical,41,31,0,72
BA,Araci,157,88,5,250
BA,Arataca,2,0,0,2
BA,Aratuípe,73,135,1,209
BA,Aurelino Leal,82,106,1,189
BA,Banzaê,0,1,0,1
BA,Barra,1860,1267,7,3134
BA,Barra da Estiva,1,0,0,1
BA,Barra do Rocha,2,0,0,2
BA,Barreiras,166,91,0,257
BA,Barro Preto,0,1,0,1
BA,Belmonte,401,377,2,780
BA,Belo Campo,4,1,0,5
BA,Boa Nova,1,0,0,1
BA,Boa Vista do Tupim,1,2,0,3
BA,Bom Jesus da Lapa,1602,1805,9,3416
BA,Bom Jesus da Serra,5,5,0,10
BA,Buritirama,1,1,0,2
BA,Caatiba,3,0,0,3
BA,Cabaceiras do Paraguaçu,27,9,2,38
BA,Cachoeira,487,820,3,1310
BA,Cairu,1048,1183,5,2236
BA,Camacan,3,1,1,5
BA,Camaçari,37,30,0,67
BA,Camamu,895,1289,6,2190
BA,Campo Alegre de Lourdes,0,1,0,1
BA,Campo Formoso,1,0,0,1
BA,Canarana,0,1,0,1
BA,Canavieiras,832,582,15,1429
BA,Candeal,1,2,0,3
BA,Candeias,141,628,0,769
BA,Cândido Sales,1,4,0,5
BA,Cansanção,72,67,3,142
BA,Canudos,155,67,1,223
BA,Caravelas,467,571,1,1039
BA,Cardeal da Silva,0,2,0,2
BA,Carinhanha,546,398,5,949
BA,Casa Nova,2459,1904,73,4436
BA,Castro Alves,4,3,0,7
BA,Catu,2,0,0,2
BA,Central,2,0,0,2
BA,Chorrochó,52,86,0,138
BA,Cícero Dantas,0,1,0,1
BA,Conde,484,1106,2,1592
BA,Cordeiros,1,0,0,1
BA,Coribe,20,18,0,38
BA,Correntina,50,14,0,64
BA,Cotegipe,452,421,10,883
BA,Curaçá,179,138,4,321
BA,Dário Meira,2,9,0,11
BA,Entre Rios,19,0,0,19
BA,Esplanada,6,3,0,9
BA,Feira de Santana,18,15,1,34
BA,Filadélfia,8,2,0,10
BA,Floresta Azul,5,2,0,7
BA,Gavião,33,7,0,40
BA,Gentio do Ouro,2,0,0,2
BA,Glória,21,44,0,65
BA,Gongogi,15,3,0,18
BA,Guanambi,62,42,0,104
BA,Guaratinga,2,1,0,3
BA,Iaçu,0,1,0,1
BA,Ibirapitanga,4,3,0,7
BA,Ibirataia,0,1,0,1
BA,Ibitiara,1,0,0,1
BA,Ibotirama,1760,1562,13,3335
BA,Ichu,1,0,0,1
BA,Igrapiúna,130,137,4,271
BA,Iguaí,0,1,0,1
BA,Ilhéus,449,724,27,1200
BA,Ipiaú,2,0,0,2
BA,Itabela,7,1,0,8
BA,Itaberaba,27,2,0,29
BA,Itabuna,14,12,0,26
BA,Itacaré,60,48,0,108
BA,Itaguaçu da Bahia,4,4,0,8
BA,Itajuípe,4,1,0,5
BA,Itamaraju,217,195,1,413
BA,Itambé,3,1,1,5
BA,Itanhém,1,1,0,2
BA,Itaparica,804,2085,15,2904
BA,Itapé,2,2,0,4
BA,Itapebi,5,4,0,9
BA,Itapitanga,0,1,0,1
BA,Itiúba,171,178,3,352
BA,Itororó,0,1,0,1
BA,Ituberá,188,272,3,463
BA,Jaborandi,5,4,0,9
BA,Jacobina,1,0,0,1
BA,Jaguarari,7,15,0,22
BA,Jaguaripe,651,1055,8,1714
BA,Jandaíra,90,146,4,240
BA,Jequié,14,25,0,39
BA,Jiquiriçá,0,1,0,1
BA,Jitaúna,6,8,0,14
BA,Juazeiro,1545,1489,25,3059
BA,Jussari,2,2,0,4
BA,Lafaiete Coutinho,0,1,0,1
BA,Lauro de Freitas,13,4,0,17
BA,Livramento do Brumado,1,0,0,1
BA,Macajuba,1,1,0,2
BA,Macururé,0,1,0,1
BA,Madre de Deus,183,904,14,1101
BA,Maetinga,0,1,0,1
BA,Mairi,2,0,0,2
BA,Malhada,651,554,3,1208
BA,Malhada de Pedras,5,1,0,6
BA,Manoel Vitorino,12,7,0,19
BA,Mansidão,3,1,0,4
BA,Maracás,17,12,3,32
BA,Maragogipe,1616,2743,33,4392
BA,Maraú,188,219,5,412
BA,Mascote,71,94,0,165
BA,Mata de São João,11,1,0,12
BA,Medeiros Neto,60,32,0,92
BA,Monte Santo,2,2,0,4
BA,Morpará,119,96,7,222
BA,Morro do Chapéu,1,0,0,1
BA,Mucuri,176,135,0,311
BA,Mundo Novo,1,1,0,2
BA,Muniz Ferreira,120,223,4,347
BA,Muquém de São Francisco,86,109,8,203
BA,Muritiba,2,5,0,7
BA,Mutuípe,0,1,0,1
BA,Nazaré,284,755,12,1051
BA,Nilo Peçanha,278,304,11,593
BA,Nordestina,1,3,0,4
BA,Nova Soure,1,1,0,2
BA,Nova Viçosa,161,172,2,335
BA,Novo Triunfo,0,1,0,1
BA,Olindina,1,1,0,2
BA,Palmas de Monte Alto,0,1,0,1
BA,Palmeiras,0,1,0,1
BA,Paratinga,1720,1792,26,3538
BA,Paripiranga,5,8,0,13
BA,Pau Brasil,10,3,0,13
BA,Paulo Afonso,11,4,0,15
BA,Pilão Arcado,313,290,11,614
BA,Pindaí,2,0,0,2
BA,Pindobaçu,23,27,2,52
BA,Piritiba,2,1,0,3
BA,Ponto Novo,54,26,0,80
BA,Porto Seguro,330,178,0,508
BA,Prado,772,753,3,1528
BA,Presidente Dutra,1,2,0,3
BA,Presidente Tancredo Neves,2,1,0,3
BA,Queimadas,0,2,0,2
BA,Quijingue,1,0,0,1
BA,Rafael Jambeiro,0,1,0,1
BA,Remanso,1011,723,8,1742
BA,Riachão das Neves,89,139,10,238
BA,Riacho de Santana,2,2,0,4
BA,Ribeirão do Largo,1,0,1,2
BA,Rio de Contas,33,11,0,44
BA,Rio Real,1,1,0,2
BA,Rodelas,469,393,10,872
BA,Ruy Barbosa,1,1,0,2
BA,Salinas da Margarida,1959,3521,13,5493
BA,Salvador,17907,20587,48,38542
BA,Santa Bárbara,0,1,0,1
BA,Santa Cruz Cabrália,69,86,2,157
BA,Santa Cruz da Vitória,2,4,0,6
BA,Santaluz,0,1,0,1
BA,Santa Luzia,8,13,0,21
BA,Santa Maria da Vitória,83,81,3,167
BA,Santana,34,14,0,48
BA,Santa Rita de Cássia,7,4,0,11
BA,Santa Teresinha,0,1,0,1
BA,Santo Amaro,1457,3322,26,4805
BA,Santo Antônio de Jesus,0,4,0,4
BA,Santo Estêvão,2,1,0,3
BA,São Félix,10,31,1,42
BA,São Félix do Coribe,1,8,0,9
BA,São Francisco do Conde,76,462,6,544
BA,São Gabriel,0,1,0,1
BA,São Gonçalo dos Campos,1,0,0,1
BA,São José do Jacuípe,6,3,0,9
BA,Sapeaçu,0,1,0,1
BA,Saubara,1335,2446,23,3804
BA,Saúde,2,2,0,4
BA,Seabra,0,3,0,3
BA,Senhor do Bonfim,104,95,3,202
BA,Sento Sé,890,1093,31,2014
BA,Serra do Ramalho,407,361,0,768
BA,Serra Dourada,1,0,0,1
BA,Serra Preta,0,1,0,1
BA,Simões Filho,20,47,1,68
BA,Sítio do Mato,109,100,4,213
BA,Sobradinho,593,630,5,1228
BA,Souto Soares,1,0,0,1
BA,Tabocas do Brejo Velho,2,2,0,4
BA,Tanquinho,0,1,0,1
BA,Taperoá,265,436,12,713
BA,Tapiramutá,0,1,0,1
BA,Teixeira de Freitas,18,5,0,23
BA,Terra Nova,0,1,0,1
BA,Tremedal,29,15,0,44
BA,Ubaíra,0,1,0,1
BA,Ubaitaba,190,250,10,450
BA,Ubatã,1,3,0,4
BA,Umburanas,0,1,0,1
BA,Una,316,292,0,608
BA,Urandi,2,0,0,2
BA,Uruçuca,3,9,0,12
BA,Valença,549,1067,46,1662
BA,Valente,2,2,0,4
BA,Várzea da Roça,13,4,0,17
BA,Varzedo,3,3,0,6
BA,Vera Cruz,2194,4842,51,7087
BA,Vereda,3,3,0,6
BA,Vitória da Conquista,1,0,0,1
BA,Wagner,0,2,0,2
BA,Wanderley,253,321,5,579
BA,Wenceslau Guimarães,2,1,0,3
BA,Xique-Xique,772,635,4,1411
CE,Abaiara,48,12,0,60
CE,Acarape,0,1,0,1
CE,Acaraú,499,441,12,952
CE,Acopiara,23,0,0,23
CE,Aiuaba,24,3,0,27
CE,Alto Santo,45,37,1,83
CE,Amontada,309,100,1,410
CE,Aquiraz,492,283,6,781
CE,Aracati,998,476,9,1483
CE,Aracoiaba,4,0,0,4
CE,Araripe,1,0,0,1
CE,Arneiroz,19,3,0,22
CE,Assaré,22,2,0,24
CE,Aurora,11,0,0,11
CE,Banabuiú,110,11,0,121
CE,Barreira,0,1,0,1
CE,Barro,43,0,0,43
CE,Barroquinha,269,138,3,410
CE,Baturité,2,2,0,4
CE,Beberibe,976,541,10,1527
CE,Bela Cruz,0,1,0,1
CE,Boa Viagem,66,2,0,68
CE,Brejo Santo,1,0,0,1
CE,Camocim,889,117,23,1029
CE,Campos Sales,41,1,0,42
CE,Canindé,98,13,1,112
CE,Capistrano,1,0,0,1
CE,Caridade,59,2,0,61
CE,Cariré,2,0,0,2
CE,Caririaçu,14,5,0,19
CE,Cariús,35,0,1,36
CE,Carnaubal,0,1,0,1
CE,Cascavel,658,349,2,1009
CE,Catarina,29,4,0,33
CE,Catunda,10,0,0,10
CE,Caucaia,256,57,1,314
CE,Cedro,52,16,0,68
CE,Chaval,72,95,0,167
CE,Choró,16,0,0,16
CE,Chorozinho,81,24,0,105
CE,Coreaú,22,0,0,22
CE,Crateús,97,19,0,116
CE,Crato,21,1,0,22
CE,Cruz,107,24,0,131
CE,Deputado Irapuan Pinheiro,5,0,0,5
CE,Ererê,5,0,0,5
CE,Eusébio,2,0,0,2
CE,Farias Brito,2,0,0,2
CE,Forquilha,120,17,0,137
CE,Fortaleza,3296,633,6,3935
CE,Fortim,729,418,5,1152
CE,Frecheirinha,0,1,0,1
CE,General Sampaio,274,51,0,325
CE,Granja,102,10,0,112
CE,Granjeiro,3,0,0,3
CE,Guaiúba,20,4,0,24
CE,Hidrolândia,90,2,1,93
CE,Horizonte,73,10,0,83
CE,Ibaretama,1,0,0,1
CE,Ibiapina,2,0,0,2
CE,Ibicuitinga,32,0,0,32
CE,Icapuí,976,377,14,1367
CE,Icó,11,0,1,12
CE,Iguatu,172,15,1,188
CE,Independência,20,2,0,22
CE,Ipaporanga,10,4,0,14
CE,Ipu,32,3,0,35
CE,Iracema,60,0,0,60
CE,Irauçuba,21,0,0,21
CE,Itaiçaba,6,2,0,8
CE,Itaitinga,30,5,0,35
CE,Itapagé,6,0,0,6
CE,Itapipoca,441,180,5,626
CE,Itapiúna,13,0,0,13
CE,Itarema,1035,580,7,1622
CE,Itatira,7,0,0,7
CE,Jaguaretama,36,1,0,37
CE,Jaguaribara,75,18,1,94
CE,Jaguaribe,72,25,0,97
CE,Jijoca de Jericoacoara,57,2,0,59
CE,Juazeiro do Norte,19,4,0,23
CE,Jucás,3,1,0,4
CE,Lavras da Mangabeira,14,0,0,14
CE,Limoeiro do Norte,0,0,1,1
CE,Madalena,11,0,0,11
CE,Maracanaú,13,1,0,14
CE,Maranguape,106,24,0,130
CE,Marco,22,10,0,32
CE,Massapê,35,8,0,43
CE,Milagres,5,0,0,5
CE,Miraíma,25,5,0,30
CE,Mombaça,1,0,0,1
CE,Monsenhor Tabosa,1,0,0,1
CE,Morada Nova,53,5,0,58
CE,Moraújo,18,0,0,18
CE,Mucambo,1,0,0,1
CE,Nova Russas,13,0,0,13
CE,Novo Oriente,57,24,0,81
CE,Ocara,7,1,0,8
CE,Orós,222,103,9,334
CE,Pacajus,138,34,0,172
CE,Pacatuba,23,2,0,25
CE,Pacujá,1,0,0,1
CE,Palmácia,1,0,0,1
CE,Paracuru,284,53,4,341
CE,Paraipaba,105,25,1,131
CE,Parambu,11,1,0,12
CE,Paramoti,8,1,0,9
CE,Pedra Branca,15,0,0,15
CE,Pentecoste,253,63,1,317
CE,Pindoretama,4,0,0,4
CE,Piquet Carneiro,4,0,0,4
CE,Pires Ferreira,43,0,0,43
CE,Poranga,3,0,0,3
CE,Potiretama,7,0,0,7
CE,Quiterianópolis,5,0,0,5
CE,Quixadá,33,3,0,36
CE,Quixelô,137,11,0,148
CE,Quixeramobim,85,17,0,102
CE,Redenção,26,3,1,30
CE,Russas,4,0,0,4
CE,Saboeiro,38,0,0,38
CE,Santana do Acaraú,1,0,0,1
CE,Santa Quitéria,81,13,0,94
CE,São Gonçalo do Amarante,87,23,1,111
CE,São Luís do Curu,7,5,0,12
CE,Senador Pompeu,91,3,0,94
CE,Senador Sá,5,0,0,5
CE,Sobral,106,20,0,126
CE,Solonópole,15,5,0,20
CE,Tamboril,60,0,0,60
CE,Tarrafas,1,0,0,1
CE,Tauá,60,23,0,83
CE,Tejuçuoca,6,0,0,6
CE,Trairi,602,301,8,911
CE,Umirim,87,7,0,94
CE,Uruburetama,1,1,0,2
CE,Uruoca,20,0,0,20
CE,Varjota,110,4,0,114
CE,Várzea Alegre,16,0,0,16
DF,Brasília,351,54,3,408
ES,Alegre,24,4,0,28
ES,Alfredo Chaves,2,0,0,2
ES,Anchieta,316,388,7,711
ES,Aracruz,304,491,13,808
ES,Atilio Vivacqua,0,1,0,1
ES,Baixo Guandu,95,41,1,137
ES,Boa Esperança,11,7,0,18
ES,Cachoeiro de Itapemirim,39,14,0,53
ES,Cariacica,149,143,2,294
ES,Colatina,139,75,5,219
ES,Conceição da Barra,497,482,23,1002
ES,Conceição do Castelo,0,1,0,1
ES,Ecoporanga,2,1,0,3
ES,Fundão,13,7,0,20
ES,Guaçuí,1,0,0,1
ES,Guarapari,632,620,12,1264
ES,Ibatiba,1,0,0,1
ES,Ibiraçu,6,0,0,6
ES,Iconha,0,1,0,1
ES,Itaguaçu,1,0,0,1
ES,Itapemirim,861,939,19,1819
ES,Jaguaré,2,0,0,2
ES,João Neiva,2,1,0,3
ES,Linhares,469,299,11,779
ES,Marataízes,972,795,31,1798
ES,Marechal Floriano,0,2,0,2
ES,Marilândia,7,5,0,12
ES,Mimoso do Sul,15,10,0,25
ES,Montanha,1,0,0,1
ES,Mucurici,2,1,0,3
ES,Nova Venécia,11,9,1,21
ES,Pedro Canário,17,8,0,25
ES,Pinheiros,4,0,0,4
ES,Piúma,199,211,15,425
ES,Presidente Kennedy,148,162,4,314
ES,Rio Bananal,3,1,0,4
ES,Rio Novo do Sul,3,2,1,6
ES,Santa Maria de Jetibá,1,2,0,3
ES,Santa Teresa,1,0,0,1
ES,São Gabriel da Palha,1,0,0,1
ES,São Mateus,510,579,10,1099
ES,Serra,860,759,17,1636
ES,Sooretama,33,27,0,60
ES,Viana,9,6,1,16
ES,Vila Velha,190,63,2,255
ES,Vitória,815,630,7,1452
GO,Águas Lindas de Goiás,12,1,0,13
GO,Alexânia,1,0,0,1
GO,Anápolis,2,0,0,2
GO,Anhanguera,6,9,0,15
GO,Aparecida de Goiânia,1,0,0,1
GO,Aragarças,203,165,0,368
GO,Aruanã,190,141,0,331
GO,Baliza,2,0,0,2
GO,Bom Jardim de Goiás,3,0,0,3
GO,Bom Jesus de Goiás,7,5,0,12
GO,Britânia,38,21,0,59
GO,Buriti Alegre,9,1,0,10
GO,Cabeceiras,2,0,0,2
GO,Cachoeira Alta,0,1,0,1
GO,Cachoeira Dourada,121,163,0,284
GO,Caçu,2,0,0,2
GO,Caldas Novas,22,4,0,26
GO,Campinaçu,2,2,0,4
GO,Campinorte,4,1,0,5
GO,Catalão,16,12,0,28
GO,Cezarina,0,2,1,3
GO,Cidade Ocidental,2,0,0,2
GO,Cocalzinho de Goiás,1,0,0,1
GO,Colinas do Sul,30,33,1,64
GO,Corumbaíba,103,71,1,175
GO,Cristalina,1,1,0,2
GO,Cumari,0,1,0,1
GO,Davinópolis,5,1,0,6
GO,Formosa,2,1,0,3
GO,Goiânia,81,44,0,125
GO,Goianira,3,1,0,4
GO,Goiás,4,1,0,5
GO,Goiatuba,6,2,0,8
GO,Gouvelândia,30,13,0,43
GO,Inaciolândia,20,10,0,30
GO,Inhumas,0,1,0,1
GO,Itajá,2,0,0,2
GO,Itumbiara,314,161,3,478
GO,Jataí,1,0,0,1
GO,Jussara,1,0,0,1
GO,Luziânia,16,3,0,19
GO,Mara Rosa,2,0,0,2
GO,Minaçu,11,8,0,19
GO,Morrinhos,4,0,0,4
GO,Niquelândia,81,81,2,164
GO,Nova Crixás,33,46,0,79
GO,Novo Gama,4,0,0,4
GO,Ouvidor,2,0,0,2
GO,Panamá,3,1,0,4
GO,Paranaiguara,19,8,0,27
GO,Pires do Rio,1,0,0,1
GO,Planaltina,13,2,0,15
GO,Quirinópolis,8,8,1,17
GO,Rio Quente,1,1,0,2
GO,Rio Verde,6,6,0,12
GO,Rubiataba,0,1,0,1
GO,Santa Helena de Goiás,1,1,0,2
GO,Santo Antônio do Descoberto,5,0,0,5
GO,São Miguel do Araguaia,179,161,2,342
GO,São Simão,143,146,0,289
GO,Três Ranchos,16,1,0,17
GO,Trindade,0,1,0,1
GO,Uruaçu,44,37,0,81
GO,Valparaíso de Goiás,8,0,0,8
GO,Vila Boa,1,0,0,1
MA,Açailândia,67,59,4,130
MA,Afonso Cunha,0,1,0,1
MA,Água Doce do Maranhão,6,10,0,16
MA,Alcântara,145,116,2,263
MA,Aldeias Altas,19,43,4,66
MA,Altamira do Maranhão,31,38,0,69
MA,Alto Alegre do Maranhão,314,533,14,861
MA,Alto Alegre do Pindaré,168,200,15,383
MA,Alto Parnaíba,1,2,1,4
MA,Amapá do Maranhão,198,267,315,780
MA,Amarante do Maranhão,1,2,0,3
MA,Anajatuba,1944,2521,68,4533
MA,Anapurus,136,188,119,443
MA,Apicum-Açu,70,97,3,170
MA,Araguanã,980,1486,31,2497
MA,Araioses,1208,1354,19,2581
MA,Arame,75,74,53,202
MA,Arari,1389,2374,12,3775
MA,Axixá,164,120,4,288
MA,Bacabal,1921,1877,114,3912
MA,Bacabeira,914,2458,18,3390
MA,Bacuri,756,647,5,1408
MA,Bacurituba,40,32,0,72
MA,Balsas,1,0,0,1
MA,Barão de Grajaú,71,85,0,156
MA,Barra do Corda,90,113,28,231
MA,Barreirinhas,393,676,1,1070
MA,Belágua,660,866,9,1535
MA,Bela Vista do Maranhão,309,401,46,756
MA,Benedito Leite,11,1,0,12
MA,Bequimão,212,169,0,381
MA,Bernardo do Mearim,1,0,15,16
MA,Boa Vista do Gurupi,485,592,39,1116
MA,Bom Jardim,1527,2061,33,3621
MA,Bom Jesus das Selvas,117,238,1,356
MA,Bom Lugar,98,146,16,260
MA,Brejo,148,367,0,515
MA,Brejo de Areia,16,12,0,28
MA,Buriti,375,309,4,688
MA,Buriti Bravo,0,1,0,1
MA,Buriticupu,300,734,11,1045
MA,Cachoeira Grande,184,200,42,426
MA,Cajapió,90,106,2,198
MA,Cajari,1714,1523,77,3314
MA,Campestre do Maranhão,8,9,0,17
MA,Cândido Mendes,197,183,91,471
MA,Cantanhede,457,457,25,939
MA,Carolina,133,88,9,230
MA,Carutapera,178,83,284,545
MA,Caxias,113,152,6,271
MA,Cedral,593,565,16,1174
MA,Central do Maranhão,45,62,2,109
MA,Centro do Guilherme,303,366,8,677
MA,Centro Novo do Maranhão,197,346,45,588
MA,Chapadinha,310,423,212,945
MA,Cidelândia,0,0,1,1
MA,Codó,200,327,29,556
MA,Coelho Neto,305,461,25,791
MA,Colinas,58,41,1,100
MA,Conceição do Lago-Açu,411,482,26,919
MA,Coroatá,373,351,9,733
MA,Cururupu,435,428,14,877
MA,Dom Pedro,12,9,0,21
MA,Duque Bacelar,176,92,1,269
MA,Esperantinópolis,102,101,5,208
MA,Estreito,109,76,2,187
MA,Fortuna,2,0,0,2
MA,Godofredo Viana,128,117,8,253
MA,Governador Archer,1,0,0,1
MA,Governador Edison Lobão,1,1,0,2
MA,Governador Luiz Rocha,1,0,0,1
MA,Governador Newton Bello,193,217,19,429
MA,Governador Nunes Freire,862,1183,16,2061
MA,Graça Aranha,3,4,0,7
MA,Grajaú,223,237,16,476
MA,Guimarães,458,556,2,1016
MA,Humberto de Campos,126,192,5,323
MA,Icatu,590,442,0,1032
MA,Igarapé do Meio,420,741,20,1181
MA,Igarapé Grande,2,2,0,4
MA,Imperatriz,254,135,1,390
MA,Itaipava do Grajaú,91,84,20,195
MA,Itapecuru Mirim,446,614,29,1089
MA,Itinga do Maranhão,386,575,26,987
MA,Jatobá,0,1,0,1
MA,Jenipapo dos Vieiras,4,2,0,6
MA,João Lisboa,0,1,0,1
MA,Joselândia,197,254,63,514
MA,Junco do Maranhão,101,127,8,236
MA,Lagoa do Mato,2,4,1,7
MA,Lagoa Grande do Maranhão,170,239,35,444
MA,Lago da Pedra,373,564,32,969
MA,Lago do Junco,208,168,13,389
MA,Lago dos Rodrigues,109,150,80,339
MA,Lago Verde,614,560,17,1191
MA,Lajeado Novo,1,0,0,1
MA,Loreto,63,45,0,108
MA,Luís Domingues,25,7,40,72
MA,Magalhães de Almeida,32,22,1,55
MA,Maracaçumé,355,518,28,901
MA,Marajá do Sena,301,341,36,678
MA,Maranhãozinho,271,373,16,660
MA,Mata Roma,37,13,2,52
MA,Matinha,2246,2445,32,4723
MA,Matões,2,1,0,3
MA,Matões do Norte,54,58,7,119
MA,Milagres do Maranhão,15,4,0,19
MA,Mirador,2,0,0,2
MA,Miranda do Norte,254,382,5,641
MA,Mirinzal,105,123,2,230
MA,Monção,508,644,24,1176
MA,Montes Altos,0,3,0,3
MA,Morros,337,390,3,730
MA,Nina Rodrigues,362,445,49,856
MA,Nova Colinas,0,1,0,1
MA,Nova Iorque,92,74,1,167
MA,Nova Olinda do Maranhão,375,416,28,819
MA,Olho d`Água das Cunhãs,354,464,12,830
MA,Olinda Nova do Maranhão,477,649,45,1171
MA,Paço do Lumiar,90,252,9,351
MA,Palmeirândia,96,114,1,211
MA,Paraibano,0,1,0,1
MA,Parnarama,7,5,0,12
MA,Pastos Bons,1,0,0,1
MA,Paulino Neves,330,449,4,783
MA,Paulo Ramos,112,100,0,212
MA,Pedreiras,281,131,5,417
MA,Pedro do Rosário,484,817,17,1318
MA,Penalva,729,741,24,1494
MA,Peri Mirim,486,475,10,971
MA,Peritoró,185,268,13,466
MA,Pindaré-Mirim,443,639,62,1144
MA,Pinheiro,2413,4013,36,6462
MA,Pio XII,1890,2750,44,4684
MA,Pirapemas,115,55,9,179
MA,Poção de Pedras,2,0,1,3
MA,Porto Franco,44,34,1,79
MA,Porto Rico do Maranhão,79,160,45,284
MA,Presidente Dutra,76,48,0,124
MA,Presidente Juscelino,293,309,1,603
MA,Presidente Médici,93,108,5,206
MA,Presidente Sarney,426,509,22,957
MA,Presidente Vargas,203,178,10,391
MA,Primeira Cruz,174,355,6,535
MA,Raposa,1025,1394,47,2466
MA,Riachão,1,2,0,3
MA,Ribamar Fiquene,58,106,12,176
MA,Rosário,1099,2432,41,3572
MA,Sambaíba,121,69,10,200
MA,Santa Helena,1635,2254,5,3894
MA,Santa Inês,356,829,19,1204
MA,Santa Luzia,1080,1497,31,2608
MA,Santa Luzia do Paruá,286,386,19,691
MA,Santana do Maranhão,67,75,8,150
MA,Santa Quitéria do Maranhão,32,29,0,61
MA,Santa Rita,407,1230,9,1646
MA,Santo Amaro do Maranhão,141,186,2,329
MA,Santo Antônio dos Lopes,2,1,0,3
MA,São Benedito do Rio Preto,624,824,12,1460
MA,São Bento,337,378,93,808
MA,São Bernardo,122,107,1,230
MA,São Domingos do Azeitão,59,38,6,103
MA,São Domingos do Maranhão,0,1,0,1
MA,São Francisco do Brejão,3,9,0,12
MA,São Francisco do Maranhão,2,2,0,4
MA,São João Batista,710,763,35,1508
MA,São João do Carú,300,466,20,786
MA,São João do Soter,1,0,0,1
MA,São João dos Patos,0,1,0,1
MA,São José de Ribamar,206,290,7,503
MA,São José dos Basílios,60,84,4,148
MA,São Luís,19750,22927,57,42735
MA,São Luís Gonzaga do Maranhão,41,58,24,123
MA,São Mateus do Maranhão,398,796,24,1218
MA,São Pedro da Água Branca,31,87,4,122
MA,São Raimundo do Doca Bezerra,30,33,5,68
MA,São Roberto,89,69,2,160
MA,São Vicente Ferrer,99,124,42,265
MA,Satubinha,341,284,51,676
MA,Senador Alexandre Costa,8,0,0,8
MA,Serrano do Maranhão,80,119,19,218
MA,Tasso Fragoso,3,1,1,5
MA,Timbiras,79,83,0,162
MA,Timon,160,254,48,462
MA,Trizidela do Vale,199,160,33,392
MA,Tufilândia,161,279,13,453
MA,Tuntum,32,45,14,91
MA,Turiaçu,238,320,5,563
MA,Turilândia,133,325,6,464
MA,Tutóia,380,746,8,1134
MA,Urbano Santos,886,1956,19,2861
MA,Vargem Grande,517,597,11,1125
MA,Viana,2915,3191,87,6193
MA,Vila Nova dos Martírios,8,4,0,12
MA,Vitória do Mearim,367,437,62,866
MA,Vitorino Freire,492,500,40,1032
MA,Zé Doca,413,632,103,1148
MG,Abadia dos Dourados,38,7,0,45
MG,Abaeté,282,234,1,517
MG,Abre Campo,2,0,0,2
MG,Acaiaca,1,0,0,1
MG,Água Comprida,10,5,0,15
MG,Aguanil,91,40,0,131
MG,Águas Formosas,35,16,0,51
MG,Águas Vermelhas,141,71,0,212
MG,Aimorés,36,19,0,55
MG,Aiuruoca,0,1,0,1
MG,Alagoa,16,8,0,24
MG,Alfenas,257,100,0,357
MG,Almenara,95,52,0,147
MG,Alpercata,6,0,0,6
MG,Alpinópolis,6,5,0,11
MG,Alterosa,70,26,0,96
MG,Araçaí,1,0,0,1
MG,Araçuaí,64,20,0,84
MG,Araguari,282,108,2,392
MG,Araporã,0,1,0,1
MG,Arapuá,4,0,0,4
MG,Araújos,0,1,0,1
MG,Araxá,2,1,0,3
MG,Arceburgo,3,0,0,3
MG,Arcos,7,0,0,7
MG,Areado,84,31,0,115
MG,Arinos,141,61,0,202
MG,Augusto de Lima,1,0,0,1
MG,Bambuí,69,27,0,96
MG,Barra Longa,7,10,0,17
MG,Barroso,1,0,0,1
MG,Belo Horizonte,757,306,0,1063
MG,Belo Oriente,5,1,0,6
MG,Belo Vale,0,1,0,1
MG,Berilo,23,3,0,26
MG,Berizal,41,43,1,85
MG,Betim,15,8,0,23
MG,Bias Fortes,1,0,0,1
MG,Biquinhas,30,14,0,44
MG,Boa Esperança,275,147,1,423
MG,Bocaina de Minas,1,0,0,1
MG,Bom Despacho,135,58,1,194
MG,Bom Jesus do Galho,1,0,0,1
MG,Bom Sucesso,12,3,0,15
MG,Bonfinópolis de Minas,1,0,0,1
MG,Botelhos,13,0,0,13
MG,Brasilândia de Minas,210,73,1,284
MG,Brasília de Minas,3,0,0,3
MG,Brumadinho,1,0,0,1
MG,Buenópolis,4,1,0,5
MG,Buritis,579,263,1,843
MG,Buritizeiro,182,162,1,345
MG,Cabeceira Grande,23,4,0,27
MG,Cabo Verde,5,1,0,6
MG,Cachoeira da Prata,1,0,0,1
MG,Cachoeira Dourada,32,27,2,61
MG,Caetanópolis,2,0,0,2
MG,Caldas,15,4,0,19
MG,Camacho,1,0,0,1
MG,Campestre,4,0,0,4
MG,Campina Verde,15,5,0,20
MG,Campo Belo,263,135,1,399
MG,Campo do Meio,211,55,1,267
MG,Campo Florido,1,1,0,2
MG,Campos Altos,5,1,0,6
MG,Campos Gerais,85,26,0,111
MG,Canápolis,48,13,0,61
MG,Cana Verde,146,82,1,229
MG,Candeias,29,10,0,39
MG,Cantagalo,1,0,0,1
MG,Capinópolis,57,34,0,91
MG,Capitão Enéas,14,3,0,17
MG,Capitólio,117,23,0,140
MG,Caratinga,1,0,0,1
MG,Carbonita,1,0,0,1
MG,Carlos Chagas,32,17,0,49
MG,Carmo da Cachoeira,2,1,0,3
MG,Carmo da Mata,1,0,0,1
MG,Carmo de Minas,1,0,0,1
MG,Carmo do Cajuru,9,3,0,12
MG,Carmo do Paranaíba,61,12,0,73
MG,Carmo do Rio Claro,214,44,2,260
MG,Carneirinho,1,0,0,1
MG,Carrancas,9,0,0,9
MG,Cascalho Rico,3,3,0,6
MG,Cássia,19,2,0,21
MG,Cataguases,10,0,0,10
MG,Caxambu,2,0,0,2
MG,Cedro do Abaeté,4,2,0,6
MG,Centralina,45,24,0,69
MG,Chapada do Norte,1,0,0,1
MG,Chapada Gaúcha,1,1,0,2
MG,Cláudio,5,2,0,7
MG,Comendador Gomes,4,0,0,4
MG,Conceição da Aparecida,10,2,0,12
MG,Conceição da Barra de Minas,3,0,0,3
MG,Conceição das Alagoas,37,25,0,62
MG,Conceição do Pará,10,8,0,18
MG,Conceição dos Ouros,2,0,0,2
MG,Cônego Marinho,1,0,0,1
MG,Conquista,65,89,1,155
MG,Conselheiro Pena,73,18,1,92
MG,Contagem,17,16,0,33
MG,Coqueiral,53,8,0,61
MG,Cordislândia,1,2,0,3
MG,Corinto,4,6,0,10
MG,Coromandel,36,8,0,44
MG,Coronel Murta,21,5,0,26
MG,Córrego Danta,1,0,0,1
MG,Crisólita,11,2,0,13
MG,Cristais,353,131,4,488
MG,Curral de Dentro,13,5,0,18
MG,Curvelo,12,6,0,18
MG,Delfinópolis,12,4,0,16
MG,Delta,3,2,0,5
MG,Descoberto,1,1,0,2
MG,Diamantina,1,0,0,1
MG,Divino,39,7,0,46
MG,Divinópolis,61,18,1,80
MG,Divisa Nova,5,0,0,5
MG,Dom Bosco,13,5,0,18
MG,Dores do Indaiá,85,40,0,125
MG,Doresópolis,72,30,0,102
MG,Douradoquara,11,3,0,14
MG,Elói Mendes,40,15,1,56
MG,Engenheiro Caldas,2,0,0,2
MG,Engenheiro Navarro,2,1,0,3
MG,Esmeraldas,1,0,0,1
MG,Estrela do Indaiá,2,1,0,3
MG,Estrela do Sul,9,2,0,11
MG,Fama,31,3,0,34
MG,Felixlândia,185,108,2,295
MG,Formiga,177,59,0,236
MG,Formoso,8,1,0,9
MG,Francisco Dumont,1,0,0,1
MG,Franciscópolis,6,2,0,8
MG,Francisco Sá,1,0,0,1
MG,Frei Inocêncio,4,0,0,4
MG,Fronteira,296,243,1,540
MG,Frutal,421,152,1,574
MG,Galiléia,7,1,0,8
MG,Gouveia,4,0,0,4
MG,Governador Valadares,139,32,1,172
MG,Grupiara,12,2,0,14
MG,Guapé,108,28,0,136
MG,Guarani,2,1,0,3
MG,Guarda-Mor,2,1,0,3
MG,Guimarânia,9,3,0,12
MG,Gurinhatã,2,0,0,2
MG,Iapu,1,0,0,1
MG,Ibiaí,195,150,0,345
MG,Ibiraci,32,4,0,36
MG,Ibirité,1,0,0,1
MG,Ibituruna,0,1,0,1
MG,Icaraí de Minas,41,14,0,55
MG,Igarapé,2,1,0,3
MG,Iguatama,40,11,0,51
MG,Ijaci,34,7,1,42
MG,Ilicínea,49,8,1,58
MG,Indaiabira,1,0,0,1
MG,Indianópolis,6,1,0,7
MG,Inhaúma,1,0,0,1
MG,Ipaba,1,0,0,1
MG,Ipatinga,8,1,0,9
MG,Ipiaçu,45,23,0,68
MG,Iraí de Minas,12,5,0,17
MG,Itabirito,1,0,0,1
MG,Itacambira,7,1,0,8
MG,Itacarambi,83,23,0,106
MG,Itamarandiba,3,0,0,3
MG,Itamarati de Minas,1,1,0,2
MG,Itamogi,3,0,0,3
MG,Itaobim,20,1,0,21
MG,Itapagipe,95,35,0,130
MG,Itapecerica,2,0,0,2
MG,Itaú de Minas,0,2,0,2
MG,Itaúna,13,7,0,20
MG,Itinga,60,30,0,90
MG,Itueta,11,1,0,12
MG,Ituiutaba,63,29,0,92
MG,Itumirim,34,14,0,48
MG,Iturama,89,46,1,136
MG,Itutinga,23,6,1,30
MG,Jacinto,33,16,0,49
MG,Jaíba,26,7,0,33
MG,Janaúba,24,7,0,31
MG,Januária,450,196,1,647
MG,Japaraíba,8,0,0,8
MG,Jenipapo de Minas,9,0,0,9
MG,Jequitaí,16,6,0,22
MG,Jequitinhonha,60,25,0,85
MG,Joaíma,1,0,0,1
MG,João Pinheiro,145,96,0,241
MG,Jordânia,0,1,0,1
MG,José Gonçalves de Minas,6,2,0,8
MG,Juatuba,2,0,0,2
MG,Juiz de Fora,4,0,0,4
MG,Juvenília,30,16,0,46
MG,Lagamar,28,8,0,36
MG,Lagoa da Prata,137,31,0,168
MG,Lagoa dos Patos,4,2,0,6
MG,Lagoa Formosa,29,10,0,39
MG,Lagoa Grande,114,35,1,150
MG,Lagoa Santa,4,1,0,5
MG,Laranjal,11,10,0,21
MG,Lassance,3,3,0,6
MG,Lavras,124,36,2,162
MG,Leme do Prado,3,0,0,3
MG,Leopoldina,6,1,0,7
MG,Limeira do Oeste,19,6,0,25
MG,Luislândia,6,3,0,9
MG,Luz,47,16,0,63
MG,Machacalis,6,1,0,7
MG,Machado,1,2,0,3
MG,Madre de Deus de Minas,7,1,0,8
MG,Malacacheta,10,5,0,15
MG,Manga,145,38,0,183
MG,Mantena,1,0,0,1
MG,Marilac,2,0,0,2
MG,Mário Campos,3,0,0,3
MG,Martinho Campos,12,7,0,19
MG,Mateus Leme,1,0,0,1
MG,Mathias Lobato,4,0,0,4
MG,Matias Cardoso,44,8,0,52
MG,Matutina,9,1,0,10
MG,Medeiros,2,1,0,3
MG,Minas Novas,1,0,0,1
MG,Mirabela,1,0,0,1
MG,Moeda,1,1,0,2
MG,Moema,112,30,0,142
MG,Monte Alegre de Minas,19,7,0,26
MG,Monte Belo,1,0,0,1
MG,Monte Carmelo,45,11,0,56
MG,Montes Claros,41,2,0,43
MG,Morada Nova de Minas,522,413,2,937
MG,Nacip Raydan,1,0,0,1
MG,Nanuque,140,69,1,210
MG,Naque,5,2,0,7
MG,Natalândia,8,0,0,8
MG,Nazareno,20,10,0,30
MG,Nepomuceno,58,26,1,85
MG,Ninheira,42,20,0,62
MG,Nova Lima,0,1,0,1
MG,Nova Ponte,39,11,0,50
MG,Nova Porteirinha,3,0,0,3
MG,Nova Serrana,46,18,0,64
MG,Novo Oriente de Minas,3,0,0,3
MG,Oliveira,3,0,0,3
MG,Oratórios,1,0,0,1
MG,Paineiras,52,28,0,80
MG,Pains,4,1,0,5
MG,Palma,53,59,0,112
MG,Papagaios,16,2,0,18
MG,Paracatu,89,51,0,140
MG,Pará de Minas,11,1,0,12
MG,Paraguaçu,13,2,1,16
MG,Paraopeba,1,2,0,3
MG,Passos,164,38,0,202
MG,Patos de Minas,249,62,2,313
MG,Patrocínio,28,7,0,35
MG,Paulistas,0,1,0,1
MG,Pavão,3,0,0,3
MG,Pedra Azul,4,0,0,4
MG,Pedras de Maria da Cruz,236,116,1,353
MG,Pedrinópolis,2,1,0,3
MG,Pedro Leopoldo,0,1,0,1
MG,Pequi,1,0,0,1
MG,Perdigão,6,0,0,6
MG,Perdizes,7,2,0,9
MG,Perdões,167,86,2,255
MG,Periquito,22,8,0,30
MG,Piau,1,0,0,1
MG,Pimenta,137,31,0,168
MG,Pintópolis,16,5,0,21
MG,Pirajuba,9,1,0,10
MG,Piranguinho,8,1,0,9
MG,Pirapetinga,1,0,0,1
MG,Pirapora,595,513,2,1110
MG,Pitangui,24,8,0,32
MG,Piumhi,266,64,1,331
MG,Planura,165,64,0,229
MG,Poços de Caldas,29,4,0,33
MG,Pocrane,1,0,0,1
MG,Pompéu,72,22,0,94
MG,Ponte Nova,3,0,0,3
MG,Ponto Chique,61,19,1,81
MG,Porteirinha,4,2,0,6
MG,Porto Firme,0,1,0,1
MG,Pouso Alegre,10,0,0,10
MG,Prata,8,1,0,9
MG,Pratápolis,2,0,0,2
MG,Pratinha,3,1,0,4
MG,Presidente Olegário,149,48,1,198
MG,Quartel Geral,7,5,0,12
MG,Resplendor,68,32,1,101
MG,Riachinho,77,23,0,100
MG,Ribeirão das Neves,8,0,0,8
MG,Ribeirão Vermelho,6,2,0,8
MG,Rio Casca,10,2,0,12
MG,Rio Paranaíba,11,0,0,11
MG,Rio Pardo de Minas,2,1,0,3
MG,Rubelita,2,1,0,3
MG,Sabará,1,0,0,1
MG,Sacramento,49,20,0,69
MG,Salinas,19,6,0,25
MG,Salto da Divisa,78,47,0,125
MG,Santa Cruz de Salinas,0,1,0,1
MG,Santa Cruz do Escalvado,1,0,0,1
MG,Santa Fé de Minas,12,3,0,15
MG,Santa Helena de Minas,1,0,0,1
MG,Santa Juliana,4,4,0,8
MG,Santa Luzia,6,4,0,10
MG,Santa Maria do Salto,6,3,0,9
MG,Santa Maria do Suaçuí,1,0,0,1
MG,Santana do Jacaré,8,1,0,9
MG,Santana do Paraíso,1,0,0,1
MG,Santa Rita do Sapucaí,1,0,0,1
MG,Santa Rosa da Serra,3,0,0,3
MG,Santa Vitória,114,74,0,188
MG,Santo Antônio do Amparo,1,1,0,2
MG,Santo Antônio do Monte,2,1,0,3
MG,Santo Antônio do Retiro,0,1,0,1
MG,Santo Hipólito,1,0,0,1
MG,São Francisco,1037,817,1,1855
MG,São Francisco de Paula,0,1,0,1
MG,São Francisco de Sales,20,10,0,30
MG,São Geraldo da Piedade,4,0,0,4
MG,São Gonçalo do Abaeté,134,101,2,237
MG,São Gonçalo do Pará,1,0,0,1
MG,São Gonçalo do Sapucaí,2,0,0,2
MG,São Gotardo,57,6,0,63
MG,São João Batista do Glória,11,2,0,13
MG,São João da Ponte,0,1,0,1
MG,São João del Rei,37,3,1,41
MG,São João do Oriente,1,1,0,2
MG,São João do Paraíso,26,9,1,36
MG,São João Nepomuceno,4,1,0,5
MG,São Joaquim de Bicas,1,0,0,1
MG,São José da Barra,22,4,0,26
MG,São José da Safira,4,1,0,5
MG,São Pedro dos Ferros,1,0,0,1
MG,São Romão,247,149,0,396
MG,São Roque de Minas,15,4,0,19
MG,São Sebastião do Paraíso,5,1,0,6
MG,São Tiago,1,0,0,1
MG,São Tomás de Aquino,0,1,0,1
MG,São Vicente de Minas,8,1,0,9
MG,Serra dos Aimorés,6,0,0,6
MG,Serra do Salitre,1,0,0,1
MG,Serrania,1,0,0,1
MG,Sete Lagoas,10,3,0,13
MG,Sobrália,1,0,0,1
MG,Taiobeiras,70,26,0,96
MG,Teófilo Otoni,1,1,0,2
MG,Tiradentes,1,1,0,2
MG,Tiros,110,27,0,137
MG,Três Corações,2,3,0,5
MG,Três Marias,437,279,1,717
MG,Três Pontas,57,32,0,89
MG,Tumiritinga,56,20,0,76
MG,Tupaciguara,61,32,1,94
MG,Turmalina,13,5,0,18
MG,Turvolândia,3,0,1,4
MG,Ubaí,3,1,0,4
MG,Uberaba,499,193,3,695
MG,Uberlândia,830,275,9,1114
MG,Umburatiba,2,1,0,3
MG,Unaí,668,177,10,855
MG,Uruana de Minas,36,15,0,51
MG,Urucuia,129,38,0,167
MG,Vargem Bonita,24,3,0,27
MG,Varginha,26,11,0,37
MG,Varjão de Minas,12,11,0,23
MG,Várzea da Palma,72,83,0,155
MG,Vazante,16,3,0,19
MG,Verdelândia,9,1,0,10
MG,Veríssimo,2,1,0,3
MG,Vespasiano,6,1,0,7
MG,Virgem da Lapa,19,1,0,20
MG,Visconde do Rio Branco,1,0,0,1
MG,Volta Grande,1,0,0,1
MS,Alcinópolis,1,0,0,1
MS,Anastácio,161,79,2,242
MS,Anaurilândia,20,8,0,28
MS,Angélica,55,23,0,78
MS,Aparecida do Taboado,15,10,0,25
MS,Aquidauana,238,111,3,352
MS,Bandeirantes,1,0,0,1
MS,Bataguassu,143,54,2,199
MS,Batayporã,5,5,0,10
MS,Bela Vista,16,12,0,28
MS,Bodoquena,2,1,0,3
MS,Bonito,206,141,0,347
MS,Brasilândia,1,0,0,1
MS,Camapuã,8,2,0,10
MS,Campo Grande,245,106,3,354
MS,Caracol,3,0,0,3
MS,Cassilândia,11,5,0,16
MS,Chapadão do Sul,8,4,0,12
MS,Corguinho,8,1,0,9
MS,Coronel Sapucaia,1,0,0,1
MS,Corumbá,961,965,9,1935
MS,Costa Rica,8,4,0,12
MS,Coxim,355,185,1,541
MS,Deodápolis,43,7,0,50
MS,Dois Irmãos do Buriti,21,6,0,27
MS,Douradina,3,1,0,4
MS,Dourados,58,11,0,69
MS,Eldorado,54,36,0,90
MS,Fátima do Sul,173,46,1,220
MS,Glória de Dourados,11,2,0,13
MS,Guia Lopes da Laguna,18,7,0,25
MS,Iguatemi,3,1,0,4
MS,Inocência,2,1,0,3
MS,Itaporã,57,13,0,70
MS,Itaquiraí,160,89,1,250
MS,Ivinhema,62,6,3,71
MS,Japorã,3,0,0,3
MS,Jardim,10,2,0,12
MS,Juti,1,0,0,1
MS,Ladário,148,223,3,374
MS,Maracaju,4,0,0,4
MS,Miranda,329,266,3,598
MS,Mundo Novo,127,71,0,198
MS,Naviraí,145,88,2,235
MS,Nioaque,11,3,0,14
MS,Nova Alvorada do Sul,5,0,0,5
MS,Nova Andradina,54,12,0,66
MS,Novo Horizonte do Sul,3,0,0,3
MS,Paranaíba,309,152,10,471
MS,Pedro Gomes,8,3,0,11
MS,Porto Murtinho,220,172,4,396
MS,Rio Brilhante,8,1,0,9
MS,Rio Verde de Mato Grosso,3,0,0,3
MS,Rochedo,12,4,1,17
MS,Santa Rita do Pardo,1,3,0,4
MS,São Gabriel do Oeste,4,3,0,7
MS,Selvíria,5,2,0,7
MS,Sidrolândia,2,0,0,2
MS,Sonora,11,8,1,20
MS,Tacuru,1,0,0,1
MS,Taquarussu,9,0,0,9
MS,Terenos,29,23,0,52
MS,Três Lagoas,194,144,0,338
MS,Vicentina,15,0,0,15
MT,Acorizal,116,64,1,181
MT,Água Boa,9,0,0,9
MT,Alta Floresta,32,7,0,39
MT,Alto Araguaia,2,1,0,3
MT,Alto Paraguai,2,0,0,2
MT,Araguaiana,89,123,0,212
MT,Araguainha,1,2,0,3
MT,Araputanga,1,0,0,1
MT,Arenápolis,3,0,0,3
MT,Aripuanã,18,13,0,31
MT,Barão de Melgaço,558,528,0,1086
MT,Barra do Bugres,205,88,1,294
MT,Barra do Garças,116,62,0,178
MT,Brasnorte,3,0,0,3
MT,Cáceres,458,276,1,735
MT,Campinápolis,9,7,0,16
MT,Campo Novo do Parecis,0,2,0,2
MT,Campo Verde,3,1,0,4
MT,Canabrava do Norte,1,1,0,2
MT,Canarana,41,10,0,51
MT,Castanheira,8,2,0,10
MT,Chapada dos Guimarães,21,12,0,33
MT,Cocalinho,17,6,0,23
MT,Colíder,45,10,0,55
MT,Colniza,5,2,0,7
MT,Comodoro,1,1,0,2
MT,Confresa,23,13,0,36
MT,Cotriguaçu,0,1,1,2
MT,Cuiabá,2538,1028,1,3567
MT,Denise,3,4,0,7
MT,Diamantino,1,2,0,3
MT,Dom Aquino,3,0,0,3
MT,General Carneiro,11,4,0,15
MT,Glória d`Oeste,1,0,0,1
MT,Guarantã do Norte,17,0,0,17
MT,Guiratinga,45,14,0,59
MT,Indiavaí,3,1,0,4
MT,Itanhangá,0,1,0,1
MT,Itiquira,4,2,0,6
MT,Jaciara,11,1,0,12
MT,Juara,20,8,0,28
MT,Juína,32,9,0,41
MT,Juruena,10,2,0,12
MT,Juscimeira,22,5,0,27
MT,Lambari d`Oeste,1,1,0,2
MT,Lucas do Rio Verde,6,2,0,8
MT,Luciára,31,14,0,45
MT,Marcelândia,2,0,0,2
MT,Matupá,13,4,0,17
MT,Mirassol d`Oeste,3,2,0,5
MT,Nobres,105,52,0,157
MT,Nortelândia,0,1,0,1
MT,Nossa Senhora do Livramento,22,20,1,43
MT,Nova Bandeirantes,5,4,0,9
MT,Nova Canaã do Norte,8,5,0,13
MT,Nova Guarita,7,3,0,10
MT,Nova Maringá,1,0,0,1
MT,Nova Monte verde,1,0,0,1
MT,Nova Mutum,15,7,0,22
MT,Nova Olímpia,2,3,0,5
MT,Nova Xavantina,74,24,0,98
MT,Novo Horizonte do Norte,3,0,0,3
MT,Novo São Joaquim,2,2,0,4
MT,Paranaíta,4,0,0,4
MT,Paranatinga,23,11,1,35
MT,Peixoto de Azevedo,86,38,0,124
MT,Planalto da Serra,2,1,0,3
MT,Poconé,229,192,0,421
MT,Pontal do Araguaia,27,13,0,40
MT,Pontes e Lacerda,16,3,0,19
MT,Porto Alegre do Norte,104,57,0,161
MT,Porto dos Gaúchos,7,2,0,9
MT,Porto Esperidião,16,4,0,20
MT,Porto Estrela,42,11,0,53
MT,Poxoréo,21,10,0,31
MT,Querência,1,0,0,1
MT,Ribeirão Cascalheira,1,0,0,1
MT,Rio Branco,1,0,0,1
MT,Rondonópolis,131,49,0,180
MT,Rosário Oeste,119,96,0,215
MT,Santa Terezinha,79,40,0,119
MT,Santo Afonso,2,1,0,3
MT,Santo Antônio do Leverger,280,193,0,473
MT,São Félix do Araguaia,23,4,0,27
MT,São José do Povo,2,0,0,2
MT,São José do Rio Claro,6,0,0,6
MT,São José dos Quatro Marcos,9,0,0,9
MT,São Pedro da Cipa,2,0,0,2
MT,Sinop,89,29,0,118
MT,Sorriso,5,6,0,11
MT,Tabaporã,5,0,0,5
MT,Tangará da Serra,8,0,0,8
MT,Tapurah,7,2,0,9
MT,Terra Nova do Norte,1,0,0,1
MT,Tesouro,63,52,0,115
MT,Torixoréu,15,5,0,20
MT,Várzea Grande,427,309,1,737
MT,Vera,3,1,0,4
MT,Vila Bela da Santíssima Trindade,26,19,0,45
MT,Vila Rica,2,2,0,4
PA,Abaetetuba,6353,3728,278,10359
PA,Abel Figueiredo,5,2,1,8
PA,Acará,860,1215,60,2135
PA,Afuá,435,383,4,822
PA,Água Azul do Norte,0,2,0,2
PA,Alenquer,1252,619,28,1899
PA,Almeirim,958,1020,32,2010
PA,Altamira,466,270,3,739
PA,Anajás,657,616,52,1325
PA,Ananindeua,17,8,3,28
PA,Anapu,17,13,0,30
PA,Augusto Corrêa,112,92,4,208
PA,Aurora do Pará,5,4,0,9
PA,Aveiro,235,119,3,357
PA,Bagre,1821,1731,74,3626
PA,Baião,3600,3478,128,7206
PA,Bannach,2,7,0,9
PA,Barcarena,1298,1362,63,2723
PA,Belém,20116,13847,42,34005
PA,Belterra,2,2,0,4
PA,Benevides,7,1,1,9
PA,Bom Jesus do Tocantins,9,9,1,19
PA,Bonito,0,2,0,2
PA,Bragança,394,417,58,869
PA,Brasil Novo,2,3,0,5
PA,Brejo Grande do Araguaia,165,145,0,310
PA,Breu Branco,2312,3419,26,5757
PA,Breves,2127,1808,79,4014
PA,Bujaru,88,159,1,248
PA,Cachoeira do Arari,4776,4765,219,9760
PA,Cachoeira do Piriá,306,279,27,612
PA,Cametá,8950,7821,835,17606
PA,Canaã dos Carajás,32,54,1,87
PA,Capanema,2,2,0,4
PA,Capitão Poço,84,63,6,153
PA,Castanhal,3,1,0,4
PA,Chaves,2959,2943,68,5970
PA,Colares,109,67,6,182
PA,Conceição do Araguaia,197,167,6,370
PA,Cumaru do Norte,33,27,2,62
PA,Curionópolis,0,2,1,3
PA,Curralinho,3778,2848,241,6867
PA,Curuá,1008,566,36,1610
PA,Curuçá,65,70,8,143
PA,Dom Eliseu,0,1,0,1
PA,Eldorado dos Carajás,75,43,2,120
PA,Faro,82,36,3,121
PA,Floresta do Araguaia,569,578,6,1153
PA,Garrafão do Norte,0,2,0,2
PA,Goianésia do Pará,422,1210,30,1662
PA,Gurupá,1093,742,14,1849
PA,Igarapé-Açu,12,11,1,24
PA,Igarapé-Miri,2045,1111,50,3206
PA,Inhangapi,3,0,0,3
PA,Ipixuna do Pará,48,13,0,61
PA,Irituia,3,3,0,6
PA,Itaituba,554,301,5,860
PA,Itupiranga,562,563,9,1134
PA,Jacareacanga,121,80,0,201
PA,Jacundá,378,506,4,888
PA,Juruti,771,390,9,1170
PA,Limoeiro do Ajuru,5454,4415,471,10340
PA,Mãe do Rio,2,1,0,3
PA,Magalhães Barata,15,7,0,22
PA,Marabá,149,93,1,243
PA,Maracanã,66,74,7,147
PA,Marapanim,199,181,6,386
PA,Marituba,5,4,1,10
PA,Medicilândia,1,0,0,1
PA,Melgaço,298,282,5,585
PA,Mocajuba,6482,6458,185,13125
PA,Moju,1178,1081,0,2259
PA,Monte Alegre,2817,1848,55,4720
PA,Mosqueiro,5,6,0,11
PA,Muaná,3830,3588,674,8092
PA,Nova Esperança do Piriá,7,4,0,11
PA,Nova Ipixuna,933,1223,47,2203
PA,Nova Timboteua,6,0,0,6
PA,Novo Progresso,77,45,0,122
PA,Novo Repartimento,1116,962,13,2091
PA,Óbidos,1846,943,58,2847
PA,Oeiras do Pará,1393,1020,40,2453
PA,Oriximiná,423,200,8,631
PA,Ourém,0,1,0,1
PA,Ourilândia do Norte,0,1,0,1
PA,Pacajá,0,3,0,3
PA,Palestina do Pará,167,208,0,375
PA,Paragominas,33,14,0,47
PA,Parauapebas,376,539,19,934
PA,Pau d`Arc,43,37,1,81
PA,Peixe-Boi,1,0,0,1
PA,Piçarra,13,16,0,29
PA,Placas,1,3,1,5
PA,Ponta de Pedras,5279,4934,28,10241
PA,Portel,785,659,9,1453
PA,Porto de Moz,1182,1002,10,2194
PA,Prainha,1623,966,24,2613
PA,Primavera,4,0,0,4
PA,Quatipuru,10,13,0,23
PA,Redenção,56,75,6,137
PA,Rio Maria,3,4,1,8
PA,Rondon do Pará,19,24,0,43
PA,Rurópolis,5,2,0,7
PA,Salinópolis,328,131,3,462
PA,Salvaterra,5110,6553,167,11830
PA,Santa Bárbara do Pará,6,4,0,10
PA,Santa Cruz do Arari,1934,2450,33,4417
PA,Santa Isabel do Pará,1,0,0,1
PA,Santa Luzia do Pará,3,1,0,4
PA,Santa Maria das Barreiras,994,1105,78,2177
PA,Santa Maria do Pará,0,3,1,4
PA,Santana do Araguaia,236,324,0,560
PA,Santarém,4759,1865,3,6627
PA,Santarém Novo,10,4,0,14
PA,Santo Antônio do Tauá,7,3,0,10
PA,São Caetano de Odivelas,93,57,4,154
PA,São Domingos do Araguaia,36,75,1,112
PA,São Domingos do Capim,184,136,0,320
PA,São Félix do Xingu,196,96,21,313
PA,São Geraldo do Araguaia,70,66,1,137
PA,São João da Ponta,56,22,0,78
PA,São João de Pirabas,24,19,10,53
PA,São João do Araguaia,162,128,4,294
PA,São Miguel do Guamá,2,6,0,8
PA,São Sebastião da Boa Vista,4108,3616,137,7861
PA,Sapucaia,7,2,0,9
PA,Senador José Porfírio,457,506,23,986
PA,Soure,4550,5814,126,10490
PA,Tailândia,31,32,1,64
PA,Terra Alta,2,2,0,4
PA,Terra Santa,202,269,1,472
PA,Tracuateua,9,12,0,21
PA,Trairão,63,47,0,110
PA,Tucumã,2,1,1,4
PA,Tucuruí,3363,4468,73,7904
PA,Ulianópolis,1,1,0,2
PA,Vigia,434,300,30,764
PA,Viseu,1281,294,39,1614
PA,Vitória do Xingu,342,392,21,755
PA,Xinguara,1,0,0,1
PB,Água Branca,5,2,0,7
PB,Aguiar,235,82,1,318
PB,Alagoa Grande,14,5,1,20
PB,Alagoa Nova,1,0,0,1
PB,Alagoinha,10,12,1,23
PB,Aparecida,25,20,0,45
PB,Araçagi,95,22,1,118
PB,Arara,62,10,1,73
PB,Areia,4,0,0,4
PB,Areial,14,0,0,14
PB,Aroeiras,363,77,1,441
PB,Baía da Traição,335,61,3,399
PB,Bananeiras,5,0,0,5
PB,Baraúna,4,0,0,4
PB,Barra de Santa Rosa,105,19,0,124
PB,Barra de São Miguel,77,15,0,92
PB,Bayeux,144,91,0,235
PB,Belém,1,0,0,1
PB,Belém do Brejo do Cruz,276,237,0,513
PB,Boa Ventura,16,18,0,34
PB,Boa Vista,9,1,0,10
PB,Bom Jesus,176,79,3,258
PB,Bonito de Santa Fé,184,64,4,252
PB,Boqueirão,647,205,4,856
PB,Borborema,2,1,0,3
PB,Brejo do Cruz,64,24,0,88
PB,Brejo dos Santos,1,0,0,1
PB,Caaporã,35,30,0,65
PB,Cabaceiras,123,42,0,165
PB,Cabedelo,646,369,13,1028
PB,Cachoeira dos Índios,93,30,9,132
PB,Cacimba de Areia,1,0,0,1
PB,Cacimba de Dentro,56,14,0,70
PB,Caiçara,1,0,0,1
PB,Cajazeiras,596,465,14,1075
PB,Cajazeirinhas,115,45,1,161
PB,Camalaú,124,77,3,204
PB,Campina Grande,46,4,0,50
PB,Caraúbas,186,98,0,284
PB,Carrapateira,11,0,0,11
PB,Catingueira,8,1,0,9
PB,Catolé do Rocha,1,0,0,1
PB,Conceição,334,478,7,819
PB,Condado,174,89,3,266
PB,Conde,274,138,3,415
PB,Congo,214,124,4,342
PB,Coremas,1280,900,16,2196
PB,Cruz do Espírito Santo,0,1,0,1
PB,Cubati,15,6,0,21
PB,Cuité,77,26,0,103
PB,Curral Velho,32,94,3,129
PB,Desterro,53,14,0,67
PB,Diamante,62,38,1,101
PB,Dona Inês,1,1,0,2
PB,Emas,170,64,1,235
PB,Esperança,21,5,0,26
PB,Fagundes,2,5,0,7
PB,Frei Martinho,3,0,0,3
PB,Guarabira,6,0,0,6
PB,Ibiara,195,208,9,412
PB,Igaracy,311,265,5,581
PB,Imaculada,6,1,0,7
PB,Ingá,29,5,0,34
PB,Itabaiana,36,12,0,48
PB,Itaporanga,37,63,1,101
PB,Itapororoca,35,14,2,51
PB,Itatuba,299,477,3,779
PB,Jericó,280,210,3,493
PB,João Pessoa,1019,358,6,1383
PB,Juazeirinho,253,71,4,328
PB,Junco do Seridó,3,0,0,3
PB,Juru,33,35,0,68
PB,Lagoa,19,14,0,33
PB,Lastro,51,2,3,56
PB,Livramento,27,8,0,35
PB,Lucena,339,225,2,566
PB,Mãe d`Água,5,0,0,5
PB,Malta,39,20,1,60
PB,Mamanguape,20,3,0,23
PB,Manaíra,30,17,4,51
PB,Marcação,88,51,0,139
PB,Mari,49,27,1,77
PB,Marizópolis,454,396,11,861
PB,Massaranduba,1,2,0,3
PB,Mataraca,70,58,0,128
PB,Mogeiro,198,48,3,249
PB,Monte Horebe,3,8,0,11
PB,Monteiro,59,12,0,71
PB,Natuba,31,16,1,48
PB,Nazarezinho,259,178,1,438
PB,Nova Floresta,27,6,0,33
PB,Nova Olinda,47,10,0,57
PB,Nova Palmeira,3,0,0,3
PB,Olho d`Água,1,0,0,1
PB,Olivedos,6,0,0,6
PB,Ouro Velho,13,5,0,18
PB,Patos,146,51,0,197
PB,Paulista,6,0,0,6
PB,Pedra Branca,6,2,0,8
PB,Pedras de Fogo,1,0,0,1
PB,Piancó,296,210,5,511
PB,Picuí,229,63,0,292
PB,Pilar,1,1,0,2
PB,Pilões,3,1,0,4
PB,Pirpirituba,1,1,0,2
PB,Pitimbu,1079,564,9,1652
PB,Pocinhos,14,8,0,22
PB,Pombal,191,55,3,249
PB,Princesa Isabel,91,153,5,249
PB,Queimadas,9,2,0,11
PB,Quixabá,2,0,0,2
PB,Remígio,36,13,1,50
PB,Riacho dos Cavalos,75,38,2,115
PB,Rio Tinto,173,209,6,388
PB,Salgadinho,0,3,0,3
PB,Salgado de São Félix,76,81,3,160
PB,Santa Cruz,23,7,0,30
PB,Santa Helena,284,222,3,509
PB,Santa Inês,474,358,24,856
PB,Santa Luzia,73,35,0,108
PB,Santana de Mangueira,83,88,9,180
PB,Santana dos Garrotes,29,18,0,47
PB,Santa Rita,218,289,2,509
PB,Santa Teresinha,2,0,0,2
PB,São Bentinho,42,26,1,69
PB,São Bento,6,1,0,7
PB,São Domingos do Cariri,19,1,0,20
PB,São Francisco,115,45,1,161
PB,São João do Cariri,1,0,0,1
PB,São João do Rio do Peixe,653,513,7,1173
PB,São João do Tigre,7,1,0,8
PB,São José da Lagoa Tapada,178,95,6,279
PB,São José de Caiana,151,113,2,266
PB,São José de Espinharas,12,6,0,18
PB,São José de Piranhas,695,531,9,1235
PB,São José do Bonfim,9,3,0,12
PB,São José do Sabugi,5,0,0,5
PB,São Mamede,17,1,0,18
PB,São Miguel de Taipu,1,0,0,1
PB,São Sebastião de Lagoa de Roça,0,1,0,1
PB,São Sebastião do Umbuzeiro,44,17,0,61
PB,Sapé,341,182,14,537
PB,Seridó,3,0,0,3
PB,Serra Branca,62,15,0,77
PB,Serra Grande,49,15,0,64
PB,Solânea,126,71,2,199
PB,Soledade,226,102,1,329
PB,Sossêgo,17,8,0,25
PB,Sousa,403,378,7,788
PB,Sumé,84,33,0,117
PB,Taperoá,33,7,1,41
PB,Tavares,10,16,0,26
PB,Teixeira,95,32,4,131
PB,Triunfo,388,387,10,785
PB,Uiraúna,207,84,8,299
PB,Umbuzeiro,19,2,0,21
PB,Várzea,8,1,0,9
PB,Vieirópolis,14,4,0,18
PE,Abreu e Lima,61,104,1,166
PE,Afogados da Ingazeira,0,2,0,2
PE,Afrânio,11,1,0,12
PE,Água Preta,5,4,2,11
PE,Águas Belas,8,17,2,27
PE,Barreiros,31,74,2,107
PE,Belém de Maria,0,1,0,1
PE,Belém de São Francisco,126,64,1,191
PE,Belo Jardim,67,21,0,88
PE,Bezerros,1,0,0,1
PE,Bonito,9,1,0,10
PE,Cabo de Santo Agostinho,99,71,3,173
PE,Cabrobó,106,69,2,177
PE,Carnaubeira da Penha,1,0,0,1
PE,Carpina,1,1,0,2
PE,Cumaru,14,9,0,23
PE,Custódia,14,5,0,19
PE,Dormentes,1,2,0,3
PE,Escada,4,0,0,4
PE,Feira Nova,12,4,1,17
PE,Fernando de Noronha,19,0,0,19
PE,Flores,1,0,0,1
PE,Floresta,75,50,5,130
PE,Frei Miguelinho,7,5,0,12
PE,Gameleira,5,4,0,9
PE,Glória do Goitá,0,1,0,1
PE,Goiana,645,1374,30,2049
PE,Granito,1,2,0,3
PE,Iati,1,0,0,1
PE,Ibimirim,396,344,3,743
PE,Igarassu,104,757,19,880
PE,Iguaraci,117,183,9,309
PE,Ilha de Itamaracá,222,346,3,571
PE,Ipojuca,109,127,3,239
PE,Ipubi,1,1,0,2
PE,Itacuruba,141,34,0,175
PE,Itambé,0,1,0,1
PE,Itapissuma,132,252,1,385
PE,Itaquitinga,0,1,0,1
PE,Jaboatão dos Guararapes,70,50,2,122
PE,Jatobá,114,167,1,282
PE,Lagoa do Carro,14,10,0,24
PE,Lagoa do Itaenga,8,10,0,18
PE,Lagoa Grande,77,70,0,147
PE,Moreno,1,1,0,2
PE,Nazaré da Mata,0,1,0,1
PE,Olinda,131,138,8,277
PE,Orocó,2,0,0,2
PE,Parnamirim,87,40,1,128
PE,Paudalho,7,4,0,11
PE,Paulista,186,273,12,471
PE,Pedra,48,9,0,57
PE,Pesqueira,1,0,0,1
PE,Petrolândia,135,77,0,212
PE,Petrolina,209,66,1,276
PE,Poção,0,1,0,1
PE,Quixaba,1,1,0,2
PE,Recife,1084,906,7,1997
PE,Riacho das Almas,0,1,0,1
PE,Rio Formoso,63,201,2,266
PE,Salgueiro,0,1,0,1
PE,Santa Cruz,7,1,0,8
PE,Santa Cruz da Baixa Verde,1,1,0,2
PE,Santa Maria da Boa Vista,609,571,24,1204
PE,Santa Terezinha,0,1,0,1
PE,São José da Coroa Grande,283,341,4,628
PE,São José do Belmonte,58,177,8,243
PE,São Lourenço da Mata,3,4,0,7
PE,Serra Talhada,54,40,2,96
PE,Serrita,20,8,0,28
PE,Sertânia,15,5,1,21
PE,Sirinhaém,155,270,13,438
PE,Solidão,0,1,0,1
PE,Tamandaré,20,32,3,55
PE,Venturosa,28,26,1,55
PI,Agricolândia,2,3,0,5
PI,Água Branca,26,11,1,38
PI,Alagoinha do Piauí,30,3,0,33
PI,Alto Longá,10,1,0,11
PI,Altos,167,151,0,318
PI,Amarante,391,269,2,662
PI,Angical do Piauí,26,19,1,46
PI,Anísio de Abreu,1,0,0,1
PI,Antônio Almeida,2,2,0,4
PI,Aroazes,45,42,3,90
PI,Arraial,56,15,0,71
PI,Barras,535,411,8,954
PI,Barreiras do Piauí,1,0,0,1
PI,Barro Duro,0,1,0,1
PI,Batalha,93,41,3,137
PI,Beneditinos,114,27,7,148
PI,Bertolínia,15,13,0,28
PI,Boa Hora,82,36,0,118
PI,Bocaina,64,37,1,102
PI,Bom Jesus,207,124,2,333
PI,Bom Princípio do Piauí,3,2,0,5
PI,Bonfim do Piauí,1,0,0,1
PI,Brasileira,20,34,2,56
PI,Buriti dos Lopes,1177,1185,5,2367
PI,Buriti dos Montes,4,4,0,8
PI,Cabeceiras do Piauí,177,164,0,341
PI,Cajueiro da Praia,754,899,16,1669
PI,Campinas do Piauí,46,17,0,63
PI,Campo Largo do Piauí,417,298,6,721
PI,Campo Maior,292,141,0,433
PI,Canavieira,17,17,1,35
PI,Canto do Buriti,1,2,0,3
PI,Capitão de Campos,244,187,1,432
PI,Caraúbas do Piauí,110,93,0,203
PI,Castelo do Piauí,29,4,0,33
PI,Caxingó,131,88,1,220
PI,Cocal,31,10,0,41
PI,Cocal de Telha,143,70,0,213
PI,Coivaras,2,0,0,2
PI,Colônia do Gurguéia,89,47,0,136
PI,Colônia do Piauí,2,0,0,2
PI,Conceição do Canindé,83,53,1,137
PI,Coronel José Dias,4,0,0,4
PI,Corrente,1,0,0,1
PI,Cristalândia do Piauí,1,0,0,1
PI,Cristino Castro,88,100,0,188
PI,Curimatá,170,45,0,215
PI,Demerval Lobão,14,12,0,26
PI,Dirceu Arcoverde,2,1,0,3
PI,Dom Inocêncio,33,15,0,48
PI,Elesbão Veloso,57,60,3,120
PI,Eliseu Martins,206,90,3,299
PI,Esperantina,154,125,0,279
PI,Flores do Piauí,29,20,0,49
PI,Floriano,133,114,4,251
PI,Francinópolis,4,2,0,6
PI,Francisco Ayres,109,64,4,177
PI,Fronteiras,18,11,0,29
PI,Guadalupe,198,303,8,509
PI,Hugo Napoleão,6,10,1,17
PI,Ilha Grande,1290,1077,19,2386
PI,Inhuma,17,0,0,17
PI,Isaías Coelho,2,0,0,2
PI,Itaueira,33,16,0,49
PI,Jacobina do Piauí,1,0,0,1
PI,Jaicós,1,0,0,1
PI,Jardim do Mulato,207,160,3,370
PI,Jerumenha,71,103,4,178
PI,Joaquim Pires,191,88,6,285
PI,Joca Marques,153,189,6,348
PI,José de Freitas,696,503,11,1210
PI,Júlio Borges,78,19,2,99
PI,Lagoa Alegre,42,29,1,72
PI,Lagoa do Barro do Piauí,1,0,0,1
PI,Landri Sales,66,145,3,214
PI,Luís Correia,1784,2095,36,3915
PI,Luzilândia,802,557,1,1360
PI,Madeiro,510,558,4,1072
PI,Manoel Emídio,249,301,2,552
PI,Marcolândia,1,0,0,1
PI,Marcos Parente,0,1,0,1
PI,Matias Olímpio,458,410,5,873
PI,Miguel Alves,264,162,6,432
PI,Miguel Leão,1,0,0,1
PI,Monsenhor Gil,4,7,1,12
PI,Monte Alegre do Piauí,0,1,0,1
PI,Morro do Chapéu do Piauí,54,81,3,138
PI,Murici dos Portelas,381,274,9,664
PI,Nazaré do Piauí,116,67,0,183
PI,Nazária,10,3,0,13
PI,Nossa Senhora de Nazaré,36,19,0,55
PI,Nossa Senhora dos Remédios,111,64,3,178
PI,Oeiras,42,18,1,61
PI,Palmeira do Piauí,67,40,0,107
PI,Palmeirais,114,57,0,171
PI,Parnaguá,149,65,3,217
PI,Parnaíba,2118,1828,18,3964
PI,Passagem Franca do Piauí,4,0,0,4
PI,Paulistana,82,53,0,135
PI,Pavussu,141,41,1,183
PI,Pedro II,104,49,0,153
PI,Picos,1,4,0,5
PI,Pimenteiras,100,26,0,126
PI,Pio IX,136,64,5,205
PI,Piracuruca,506,326,8,840
PI,Piripiri,164,109,1,274
PI,Porto,329,185,4,518
PI,Prata do Piauí,34,18,1,53
PI,Queimada Nova,0,0,1,1
PI,Redenção do Gurguéia,55,19,0,74
PI,Regeneração,13,4,0,17
PI,Ribeiro Gonçalves,3,15,0,18
PI,Rio Grande do Piauí,119,11,1,131
PI,Santa Cruz do Piauí,1,0,0,1
PI,Santa Cruz dos Milagres,4,3,0,7
PI,Santa Filomena,12,3,0,15
PI,Santa Luz,5,2,0,7
PI,Santa Rosa do Piauí,2,0,0,2
PI,Santo Antônio de Lisboa,1,0,0,1
PI,Santo Antônio dos Milagres,38,58,0,96
PI,São Félix do Piauí,1,0,0,1
PI,São Francisco do Piauí,78,37,0,115
PI,São Gonçalo do Piauí,39,20,1,60
PI,São João da Canabrava,14,8,0,22
PI,São João da Fronteira,11,0,0,11
PI,São João da Serra,1,0,0,1
PI,São João do Arraial,57,38,1,96
PI,São João do Piauí,139,59,0,198
PI,São José do Divino,62,37,5,104
PI,São José do Peixe,8,1,0,9
PI,São José do Piauí,6,0,0,6
PI,São Miguel do Tapuio,10,1,0,11
PI,São Pedro do Piauí,31,34,0,65
PI,São Raimundo Nonato,125,68,2,195
PI,Sigefredo Pacheco,60,40,4,104
PI,Simplício Mendes,51,23,0,74
PI,Socorro do Piauí,79,26,7,112
PI,Teresina,2906,1976,6,4888
PI,União,322,231,0,553
PI,Uruçuí,203,156,1,360
PI,Valença do Piauí,30,38,0,68
PI,Várzea Grande,0,1,0,1
PR,Altônia,54,22,0,76
PR,Alto Paraíso,18,14,1,33
PR,Alto Paraná,7,0,1,8
PR,Alvorada do Sul,43,17,0,60
PR,Andirá,5,1,0,6
PR,Antonina,363,363,16,742
PR,Apucarana,1,1,0,2
PR,Arapongas,4,0,0,4
PR,Assaí,0,1,0,1
PR,Astorga,3,1,0,4
PR,Atalaia,1,0,0,1
PR,Bandeirantes,8,1,0,9
PR,Bela Vista do Paraíso,17,4,0,21
PR,Bom Sucesso,1,0,0,1
PR,Borrazópolis,2,0,0,2
PR,Cafeara,1,1,0,2
PR,Califórnia,1,0,0,1
PR,Cambará,1,0,0,1
PR,Cambé,19,4,0,23
PR,Campo Mourão,1,0,0,1
PR,Carlópolis,68,15,0,83
PR,Cascavel,3,0,0,3
PR,Centenário do Sul,86,38,0,124
PR,Colorado,10,1,0,11
PR,Cornélio Procópio,4,2,0,6
PR,Corumbataí do Sul,1,0,0,1
PR,Cruzeiro do Iguaçu,1,0,0,1
PR,Cruzeiro do Sul,1,1,0,2
PR,Curitiba,340,214,2,556
PR,Curiúva,2,0,0,2
PR,Diamante do Norte,44,20,0,64
PR,Doutor Camargo,1,0,0,1
PR,Entre Rios do Oeste,18,9,0,27
PR,Esperança Nova,0,1,0,1
PR,Farol,1,0,0,1
PR,Faxinal,1,1,0,2
PR,Fênix,6,2,0,8
PR,Floresta,2,0,0,2
PR,Florestópolis,7,3,0,10
PR,Foz do Iguaçu,174,74,0,248
PR,Foz do Jordão,1,0,0,1
PR,Francisco Alves,1,2,0,3
PR,Francisco Beltrão,1,0,0,1
PR,Guaíra,391,326,1,718
PR,Guaraci,2,1,1,4
PR,Guarapuava,1,1,0,2
PR,Guaraqueçaba,632,563,40,1235
PR,Guaratuba,492,209,17,718
PR,Ibiporã,35,14,0,49
PR,Icaraíma,85,83,0,168
PR,Iguaraçu,1,0,0,1
PR,Iguatu,1,0,0,1
PR,Inajá,53,68,1,122
PR,Iporã,5,4,0,9
PR,Itaguajé,17,6,0,23
PR,Itaipulândia,52,28,0,80
PR,Itambaracá,29,8,0,37
PR,Itaúna do Sul,6,6,0,12
PR,Ivaiporã,1,0,0,1
PR,Ivaté,1,0,0,1
PR,Jaguapitã,5,2,0,7
PR,Jandaia do Sul,1,0,0,1
PR,Jardim Olinda,35,30,0,65
PR,Jataizinho,30,11,0,41
PR,Kaloré,1,0,0,1
PR,Leópolis,8,1,0,9
PR,Lidianópolis,16,6,0,22
PR,Loanda,2,3,0,5
PR,Lobato,1,1,0,2
PR,Londrina,85,22,0,107
PR,Lunardelli,1,0,0,1
PR,Lupionópolis,25,4,0,29
PR,Mandaguari,1,0,0,1
PR,Marechal Cândido Rondon,42,13,0,55
PR,Marilena,148,80,0,228
PR,Maringá,12,1,0,13
PR,Matinhos,113,42,4,159
PR,Medianeira,8,1,0,9
PR,Mercedes,25,10,0,35
PR,Miraselva,2,0,0,2
PR,Missal,9,4,0,13
PR,Morretes,6,0,1,7
PR,Nossa Senhora das Graças,5,1,0,6
PR,Nova Esperança,21,5,0,26
PR,Nova Londrina,28,7,0,35
PR,Nova Olímpia,1,0,0,1
PR,Paiçandu,2,0,0,2
PR,Paranacity,11,3,0,14
PR,Paranaguá,403,287,30,720
PR,Paranapoema,10,4,0,14
PR,Paranavaí,24,4,0,28
PR,Pato Bragado,20,12,0,32
PR,Pérola,3,1,0,4
PR,Ponta Grossa,0,1,0,1
PR,Pontal do Paraná,108,77,1,186
PR,Porecatu,12,12,0,24
PR,Porto Rico,163,94,4,261
PR,Prado Ferreira,1,0,0,1
PR,Primeiro de Maio,67,22,0,89
PR,Querência do Norte,141,79,0,220
PR,Quinta do Sol,4,1,0,5
PR,Rancho Alegre,13,7,0,20
PR,Ribeirão Claro,11,3,0,14
PR,Rolândia,4,1,0,5
PR,Rondon,32,15,0,47
PR,Salto do Itararé,76,17,0,93
PR,Santa Cruz de Monte Castelo,11,5,0,16
PR,Santa Fé,0,1,0,1
PR,Santa Helena,82,42,0,124
PR,Santa Inês,4,1,0,5
PR,Santa Isabel do Ivaí,3,1,0,4
PR,Santa Izabel do Oeste,0,1,0,1
PR,Santa Mariana,28,7,0,35
PR,Santa Terezinha de Itaipu,71,39,0,110
PR,Santo Antônio do Caiuá,8,4,0,12
PR,Santo Inácio,7,2,0,9
PR,São Carlos do Ivaí,3,1,0,4
PR,São João,1,0,0,1
PR,São João do Caiuá,11,3,0,14
PR,São João do Ivaí,21,3,0,24
PR,São Jorge do Ivaí,1,0,0,1
PR,São Jorge do Patrocínio,80,9,0,89
PR,São Manoel do Paraná,1,0,0,1
PR,São Miguel do Iguaçu,44,16,0,60
PR,São Pedro do Iguaçu,0,2,0,2
PR,São Pedro do Ivaí,5,1,0,6
PR,São Pedro do Paraná,72,93,2,167
PR,Sarandi,3,2,0,5
PR,Sertaneja,17,3,0,20
PR,Sertanópolis,22,7,0,29
PR,Siqueira Campos,11,0,0,11
PR,Tamboara,1,0,0,1
PR,Telêmaco Borba,5,6,0,11
PR,Terra Rica,15,5,0,20
PR,Terra Roxa,28,13,0,41
PR,Toledo,3,3,0,6
PR,Turvo,1,0,0,1
PR,Umuarama,2,3,0,5
PR,Uniflor,5,0,0,5
PR,Uraí,9,1,0,10
PR,Xambrê,1,0,0,1
RJ,Angra dos Reis,529,15,9,553
RJ,Aperibé,19,3,2,24
RJ,Araruama,122,7,13,142
RJ,Armação dos Búzios,44,0,1,45
RJ,Arraial do Cabo,358,35,15,408
RJ,Belford Roxo,8,0,0,8
RJ,Bom Jesus do Itabapoana,13,18,0,31
RJ,Cabo Frio,447,60,36,543
RJ,Cachoeiras de Macacu,4,0,0,4
RJ,Cambuci,33,0,0,33
RJ,Campos dos Goytacazes,866,251,51,1168
RJ,Cantagalo,25,0,1,26
RJ,Cardoso Moreira,28,6,0,34
RJ,Carmo,4,2,0,6
RJ,Casimiro de Abreu,8,3,1,12
RJ,Duas Barras,1,0,0,1
RJ,Duque de Caxias,90,14,0,104
RJ,Guapimirim,15,0,1,16
RJ,Iguaba Grande,30,6,11,47
RJ,Itaboraí,46,5,18,69
RJ,Itaguaí,188,76,5,269
RJ,Italva,47,21,1,69
RJ,Itaocara,73,6,2,81
RJ,Itaperuna,104,47,3,154
RJ,Itatiaia,39,1,0,40
RJ,Japeri,2,0,0,2
RJ,Laje do Muriaé,2,0,0,2
RJ,Macaé,283,27,30,340
RJ,Magé,210,63,7,280
RJ,Mangaratiba,168,62,4,234
RJ,Maricá,113,11,5,129
RJ,Natividade,22,2,0,24
RJ,Niterói,202,29,12,243
RJ,Nova Iguaçu,6,2,1,9
RJ,Paraty,526,90,67,683
RJ,Paty do Alferes,1,0,0,1
RJ,Petrópolis,1,0,0,1
RJ,Pinheiral,1,0,0,1
RJ,Porciúncula,8,0,0,8
RJ,Queimados,2,0,0,2
RJ,Quissamã,107,10,2,119
RJ,Resende,5,1,1,7
RJ,Rio Bonito,2,0,0,2
RJ,Rio Claro,2,0,0,2
RJ,Rio das Ostras,62,1,1,64
RJ,Rio de Janeiro,3663,562,41,4266
RJ,Santa Maria Madalena,1,0,0,1
RJ,Santo Antônio de Pádua,85,11,1,97
RJ,São Fidélis,88,15,4,107
RJ,São Francisco de Itabapoana,533,351,77,961
RJ,São Gonçalo,664,318,112,1094
RJ,São João da Barra,323,36,30,389
RJ,São João de Meriti,3,0,0,3
RJ,São Pedro da Aldeia,256,27,45,328
RJ,São Sebastião do Alto,1,0,0,1
RJ,Sapucaia,11,1,2,14
RJ,Saquarema,364,94,22,480
RJ,Seropédica,2,0,0,2
RJ,Silva Jardim,28,11,1,40
RJ,Sumidouro,0,1,0,1
RJ,Trajano de Moraes,1,0,0,1
RJ,Três Rios,9,0,0,9
RN,Acari,221,201,0,422
RN,Açu,802,816,8,1626
RN,Afonso Bezerra,36,20,0,56
RN,Água Nova,2,0,0,2
RN,Alexandria,151,144,6,301
RN,Almino Afonso,33,5,2,40
RN,Alto do Rodrigues,23,34,2,59
RN,Angicos,44,9,0,53
RN,Antônio Martins,19,0,1,20
RN,Apodi,401,159,4,564
RN,Areia Branca,300,94,1,395
RN,Arês,107,61,0,168
RN,Augusto Severo,4,4,0,8
RN,Baía Formosa,262,226,4,492
RN,Barcelona,2,1,0,3
RN,Bento Fernandes,2,0,0,2
RN,Bodó,2,2,0,4
RN,Bom Jesus,1,1,0,2
RN,Brejinho,2,1,0,3
RN,Caiçara do Norte,482,140,8,630
RN,Caicó,158,49,1,208
RN,Campo Grande,598,736,22,1356
RN,Campo Redondo,3,1,0,4
RN,Canguaretama,139,135,9,283
RN,Caraúbas,245,115,5,365
RN,Carnaúba dos Dantas,15,9,0,24
RN,Carnaubais,9,4,0,13
RN,Ceará-Mirim,215,72,0,287
RN,Cerro Corá,0,1,0,1
RN,Coronel Ezequiel,7,1,0,8
RN,Cruzeta,136,96,1,233
RN,Currais Novos,170,133,0,303
RN,Doutor Severiano,2,0,0,2
RN,Encanto,29,1,0,30
RN,Equador,3,0,0,3
RN,Extremoz,259,214,0,473
RN,Felipe Guerra,119,24,0,143
RN,Fernando Pedroza,26,27,0,53
RN,Florânia,9,2,0,11
RN,Francisco Dantas,13,1,0,14
RN,Frutuoso Gomes,135,10,3,148
RN,Galinhos,94,79,1,174
RN,Goianinha,25,7,1,33
RN,Governador Dix-Sept Rosado,2,1,0,3
RN,Grossos,178,165,1,344
RN,Guamaré,18,20,0,38
RN,Ipanguaçu,212,431,1,644
RN,Itajá,85,211,0,296
RN,Itaú,92,44,3,139
RN,Jaçanã,1,0,0,1
RN,Janduís,41,27,0,68
RN,Japi,1,0,0,1
RN,Jardim de Piranhas,9,1,0,10
RN,Jardim do Seridó,129,63,1,193
RN,João Câmara,79,45,0,124
RN,João Dias,8,0,0,8
RN,José da Penha,7,5,0,12
RN,Jucurutu,430,224,8,662
RN,Lagoa d`Anta,4,0,2,6
RN,Lagoa de Pedras,1,0,0,1
RN,Lagoa de Velhos,7,8,0,15
RN,Lagoa Nova,7,2,0,9
RN,Lagoa Salgada,1,0,0,1
RN,Lajes Pintadas,7,3,0,10
RN,Lucrécia,120,5,0,125
RN,Luís Gomes,12,0,0,12
RN,Macaíba,133,78,2,213
RN,Macau,379,398,3,780
RN,Marcelino Vieira,66,27,1,94
RN,Martins,34,1,0,35
RN,Maxaranguape,343,214,3,560
RN,Messias Targino,5,9,1,15
RN,Monte Alegre,1,0,1,2
RN,Monte das Gameleiras,3,3,0,6
RN,Mossoró,120,41,2,163
RN,Natal,952,327,8,1287
RN,Nísia Floresta,431,267,0,698
RN,Nova Cruz,15,15,2,32
RN,Olho-d`Água do Borges,50,10,0,60
RN,Ouro Branco,3,0,0,3
RN,Paraná,6,0,0,6
RN,Paraú,131,100,1,232
RN,Parelhas,120,22,0,142
RN,Parnamirim,73,39,0,112
RN,Passa e Fica,16,3,1,20
RN,Patu,94,94,2,190
RN,Pau dos Ferros,147,85,0,232
RN,Pedra Grande,120,67,1,188
RN,Pedra Preta,1,0,0,1
RN,Pedro Avelino,1,0,0,1
RN,Pedro Velho,1,1,0,2
RN,Pendências,202,132,1,335
RN,Pilões,10,1,0,11
RN,Poço Branco,96,46,1,143
RN,Portalegre,5,1,0,6
RN,Porto do Mangue,183,65,0,248
RN,Presidente Juscelino,1,0,0,1
RN,Pureza,11,0,0,11
RN,Rafael Fernandes,138,101,0,239
RN,Rafael Godeiro,2,0,0,2
RN,Riacho da Cruz,35,8,0,43
RN,Riacho de Santana,21,5,0,26
RN,Riachuelo,4,0,0,4
RN,Rio do Fogo,645,383,7,1035
RN,Rodolfo Fernandes,11,3,0,14
RN,Santa Cruz,113,40,3,156
RN,Santana do Matos,236,136,0,372
RN,Santana do Seridó,1,0,0,1
RN,Santo Antônio,12,4,0,16
RN,São Bento do Norte,16,0,0,16
RN,São Bento do Trairí,3,2,0,5
RN,São Fernando,1,0,0,1
RN,São Francisco do Oeste,3,3,0,6
RN,São Gonçalo do Amarante,33,15,0,48
RN,São João do Sabugi,209,127,4,340
RN,São José de Mipibu,32,19,0,51
RN,São José do Campestre,52,23,0,75
RN,São José do Seridó,81,30,0,111
RN,São Miguel,143,10,1,154
RN,São Paulo do Potengi,228,92,3,323
RN,São Pedro,0,1,0,1
RN,São Rafael,649,496,2,1147
RN,São Tomé,0,3,0,3
RN,São Vicente,2,0,0,2
RN,Senador Elói de Souza,2,0,0,2
RN,Senador Georgino Avelino,8,26,2,36
RN,Serra de São Bento,25,0,0,25
RN,Serra do Mel,1,0,0,1
RN,Serra Negra do Norte,29,3,0,32
RN,Serrinha,1,0,0,1
RN,Severiano Melo,55,29,1,85
RN,Sítio Novo,87,41,1,129
RN,Taboleiro Grande,34,14,0,48
RN,Tangará,249,208,2,459
RN,Tenente Ananias,8,1,1,10
RN,Tibau,107,87,0,194
RN,Tibau do Sul,503,307,3,813
RN,Timbaúba dos Batistas,3,0,0,3
RN,Touros,899,408,4,1311
RN,Triunfo Potiguar,128,202,3,333
RN,Umarizal,144,99,4,247
RN,Upanema,205,210,6,421
RN,Vila Flor,3,0,0,3
RO,Alta Floresta d`Oeste,15,5,0,20
RO,Alto Paraíso,8,2,0,10
RO,Alvorada d`Oeste,2,1,0,3
RO,Ariquemes,78,48,3,129
RO,Buritis,58,17,2,77
RO,Cabixi,54,10,1,65
RO,Cacoal,17,9,0,26
RO,Campo Novo de Rondônia,3,4,0,7
RO,Candeias do Jamari,153,165,2,320
RO,Cerejeiras,8,1,0,9
RO,Colorado do Oeste,3,3,0,6
RO,Corumbiara,1,0,0,1
RO,Costa Marques,118,56,4,178
RO,Cujubim,4,1,0,5
RO,Espigão d`Oeste,0,2,0,2
RO,Governador Jorge Teixeira,1,0,0,1
RO,Guajará-Mirim,174,90,3,267
RO,Itapuã do Oeste,125,143,5,273
RO,Jaru,35,10,0,45
RO,Ji-Paraná,112,52,0,164
RO,Machadinho d`Oeste,80,54,3,137
RO,Ministro Andreazza,1,0,0,1
RO,Monte Negro,1,0,0,1
RO,Nova Brasilândia d`Oeste,1,0,0,1
RO,Nova Mamoré,22,11,1,34
RO,Nova União,3,0,0,3
RO,Ouro Preto do Oeste,14,3,0,17
RO,Pimenta Bueno,28,17,0,45
RO,Pimenteiras do Oeste,77,37,1,115
RO,Porto Velho,2814,3034,27,5875
RO,Presidente Médici,39,9,0,48
RO,Rolim de Moura,6,3,0,9
RO,São Francisco do Guaporé,105,59,0,164
RO,São Miguel do Guaporé,5,3,0,8
RO,Seringueiras,35,11,0,46
RO,Urupá,6,0,1,7
RO,Vale do Anari,3,0,0,3
RO,Vale do Paraíso,7,2,0,9
RR,Alto Alegre,51,27,0,78
RR,Amajari,76,75,0,151
RR,Boa Vista,1434,859,2,2295
RR,Bonfim,110,77,1,188
RR,Cantá,143,122,0,265
RR,Caracaraí,944,782,2,1728
RR,Caroebe,38,15,0,53
RR,Iracema,145,127,0,272
RR,Mucajaí,185,201,1,387
RR,Normandia,44,39,0,83
RR,Pacaraima,22,17,0,39
RR,Rorainópolis,340,267,4,611
RR,São João da Baliza,66,40,0,106
RR,São Luiz,99,63,0,162
RR,Uiramutã,1,0,0,1
RS,Ajuricaba,3,0,0,3
RS,Alecrim,52,19,0,71
RS,Alegrete,27,10,1,38
RS,Alpestre,20,2,0,22
RS,Alto Alegre,5,1,0,6
RS,Alvorada,41,0,0,41
RS,Ametista do Sul,3,0,0,3
RS,André da Rocha,1,0,0,1
RS,Antônio Prado,1,0,0,1
RS,Arambaré,21,2,0,23
RS,Aratiba,34,2,0,36
RS,Arroio do Meio,29,4,1,34
RS,Arroio do Sal,103,33,0,136
RS,Arroio dos Ratos,3,1,0,4
RS,Arroio do Tigre,43,1,0,44
RS,Arroio Grande,102,64,0,166
RS,Augusto Pestana,18,0,0,18
RS,Bagé,4,0,0,4
RS,Balneário Pinhal,51,26,0,77
RS,Barracão,2,0,0,2
RS,Barra do Guarita,16,4,0,20
RS,Barra do Quarai,3,0,0,3
RS,Barra do Ribeiro,22,6,0,28
RS,Barra do Rio Azul,11,2,0,13
RS,Bento Gonçalves,2,0,0,2
RS,Bom Princípio,8,0,0,8
RS,Bom Retiro do Sul,14,2,0,16
RS,Bossoroca,1,0,0,1
RS,Bozano,1,0,0,1
RS,Caçapava do Sul,2,1,0,3
RS,Cacequi,10,0,0,10
RS,Cachoeira do Sul,112,46,0,158
RS,Cachoeirinha,40,1,0,41
RS,Caibaté,8,0,0,8
RS,Caiçara,5,3,0,8
RS,Camaquã,12,4,0,16
RS,Campina das Missões,2,0,0,2
RS,Campinas do Sul,39,9,0,48
RS,Campo Bom,34,1,0,35
RS,Campos Borges,8,1,0,9
RS,Candelária,4,0,0,4
RS,Cândido Godói,1,0,0,1
RS,Canela,1,0,0,1
RS,Canoas,183,32,0,215
RS,Capão da Canoa,131,23,0,154
RS,Capão do Leão,4,0,0,4
RS,Capela de Santana,34,8,1,43
RS,Carazinho,1,0,0,1
RS,Carlos Barbosa,4,0,0,4
RS,Catuípe,5,1,0,6
RS,Caxias do Sul,11,1,0,12
RS,Cerro Grande,1,0,0,1
RS,Cerro Grande do Sul,2,0,0,2
RS,Cerro Largo,2,1,0,3
RS,Charqueadas,56,20,0,76
RS,Chiapetta,2,0,0,2
RS,Cidreira,100,36,0,136
RS,Colinas,1,0,0,1
RS,Constantina,2,0,0,2
RS,Coronel Barros,9,0,0,9
RS,Crissiumal,9,3,0,12
RS,Cristal,3,0,0,3
RS,Cruz Alta,3,0,0,3
RS,Cruzeiro do Sul,19,1,0,20
RS,Derrubadas,2,0,0,2
RS,Dezesseis de Novembro,10,0,0,10
RS,Dois Irmãos,4,0,0,4
RS,Dom Pedrito,3,0,0,3
RS,Doutor Maurício Cardoso,7,3,0,10
RS,Eldorado do Sul,59,20,0,79
RS,Encantado,7,1,0,8
RS,Entre-Ijuís,21,1,0,22
RS,Erechim,10,0,0,10
RS,Ernestina,9,0,0,9
RS,Erval Grande,34,13,0,47
RS,Erval Seco,1,0,0,1
RS,Esperança do Sul,21,7,0,28
RS,Espumoso,2,0,0,2
RS,Estância Velha,13,0,0,13
RS,Esteio,49,5,0,54
RS,Estrela,30,3,0,33
RS,Eugênio de Castro,2,0,0,2
RS,Fagundes Varela,1,0,0,1
RS,Faxinalzinho,6,0,0,6
RS,Feliz,6,0,0,6
RS,Formigueiro,1,0,0,1
RS,Fortaleza dos Valos,21,3,0,24
RS,Frederico Westphalen,7,2,0,9
RS,Garruchos,160,96,0,256
RS,General Câmara,84,52,0,136
RS,Getúlio Vargas,4,1,0,5
RS,Giruá,5,0,0,5
RS,Glorinha,3,0,0,3
RS,Gramado,1,0,0,1
RS,Gravataí,75,3,0,78
RS,Guabiju,1,0,0,1
RS,Guaíba,43,12,0,55
RS,Harmonia,2,0,0,2
RS,Ibirapuitã,7,0,0,7
RS,Ibirubá,3,0,0,3
RS,Igrejinha,20,0,0,20
RS,Ijuí,141,9,0,150
RS,Ilópolis,1,0,0,1
RS,Imbé,319,48,2,369
RS,Ipiranga do Sul,1,0,0,1
RS,Iraí,33,13,0,46
RS,Itapuca,0,1,0,1
RS,Itaqui,126,67,0,193
RS,Itatiba do Sul,10,3,0,13
RS,Ivorá,1,0,0,1
RS,Ivoti,9,0,0,9
RS,Jacuizinho,2,0,0,2
RS,Jaguarão,61,37,0,98
RS,Jaguari,3,0,0,3
RS,Jaquirana,1,0,0,1
RS,Jóia,2,0,0,2
RS,Júlio de Castilhos,1,0,0,1
RS,Lajeado,48,1,1,50
RS,Lindolfo Collor,6,0,0,6
RS,Machadinho,3,1,0,4
RS,Manoel Viana,26,14,0,40
RS,Maquiné,52,17,0,69
RS,Marau,2,0,0,2
RS,Marcelino Ramos,40,10,0,50
RS,Mariano Moro,54,15,0,69
RS,Marques de Souza,2,0,0,2
RS,Monte Alegre dos Campos,1,0,0,1
RS,Monte Belo do Sul,2,0,0,2
RS,Montenegro,46,1,0,47
RS,Morrinhos do Sul,1,0,0,1
RS,Morro Reuter,1,0,0,1
RS,Mostardas,93,63,0,156
RS,Muçum,1,0,0,1
RS,Muliterno,0,1,0,1
RS,Não-Me-Toque,5,2,0,7
RS,Nonoai,10,6,0,16
RS,Nova Hartz,8,0,0,8
RS,Nova Petrópolis,2,0,0,2
RS,Nova Santa Rita,62,16,0,78
RS,Novo Barreiro,1,0,0,1
RS,Novo Hamburgo,60,5,1,66
RS,Novo Machado,1,0,0,1
RS,Osório,88,10,0,98
RS,Palmares do Sul,277,173,1,451
RS,Panambi,3,1,0,4
RS,Pareci Novo,22,0,0,22
RS,Parobé,19,0,0,19
RS,Passo do Sobrado,8,0,0,8
RS,Passo Fundo,6,0,0,6
RS,Pelotas,654,436,3,1093
RS,Picada Café,1,0,0,1
RS,Pinhal,47,20,0,67
RS,Pinhal Grande,1,0,0,1
RS,Pinheirinho do Vale,11,7,0,18
RS,Pinheiro Machado,0,2,0,2
RS,Pirapó,81,49,1,131
RS,Planalto,2,0,0,2
RS,Ponte Preta,1,0,0,1
RS,Portão,24,2,0,26
RS,Porto Alegre,1309,414,1,1724
RS,Porto Lucena,51,28,0,79
RS,Porto Mauá,26,7,0,33
RS,Porto Vera Cruz,30,14,0,44
RS,Porto Xavier,103,61,0,164
RS,Quaraí,28,10,0,38
RS,Quinze de Novembro,8,2,0,10
RS,Redentora,1,0,0,1
RS,Restinga Seca,16,2,0,18
RS,Rio dos Índios,24,7,1,32
RS,Rio Grande,1433,415,4,1852
RS,Rio Pardo,83,31,0,114
RS,Riozinho,1,0,0,1
RS,Roca Sales,3,0,0,3
RS,Ronda Alta,1,0,0,1
RS,Roque Gonzales,22,8,0,30
RS,Rosário do Sul,37,0,0,37
RS,Saldanha Marinho,2,0,0,2
RS,Salto do Jacuí,183,35,0,218
RS,Salvador do Sul,1,0,0,1
RS,Santa Cruz do Sul,53,4,0,57
RS,Santa Maria,33,5,0,38
RS,Santa Rosa,8,4,0,12
RS,Santa Vitória do Palmar,155,74,0,229
RS,Santiago,2,0,0,2
RS,Santo Ângelo,31,4,1,36
RS,Santo Antônio da Patrulha,8,0,1,9
RS,Santo Antônio das Missões,6,2,0,8
RS,Santo Augusto,3,0,0,3
RS,Santo Cristo,4,0,0,4
RS,São Borja,148,56,0,204
RS,São Francisco de Assis,16,2,0,18
RS,São Gabriel,165,19,1,185
RS,São Jerônimo,92,52,0,144
RS,São José do Hortêncio,4,1,0,5
RS,São José do Inhacorá,7,2,0,9
RS,São José do Norte,1456,518,3,1977
RS,São José do Ouro,4,0,0,4
RS,São José dos Ausentes,0,1,0,1
RS,São Leopoldo,74,6,0,80
RS,São Lourenço do Sul,201,74,0,275
RS,São Luiz Gonzaga,17,1,0,18
RS,São Martinho,2,0,0,2
RS,São Miguel das Missões,3,0,0,3
RS,São Nicolau,137,81,0,218
RS,São Paulo das Missões,1,0,0,1
RS,São Sebastião do Caí,22,0,0,22
RS,Sapiranga,22,1,1,24
RS,Sapucaia do Sul,105,11,0,116
RS,Sarandi,5,0,0,5
RS,Segredo,2,0,0,2
RS,Selbach,7,0,0,7
RS,Sentinela do Sul,1,0,0,1
RS,Severiano de Almeida,8,2,0,10
RS,Sinimbu,1,0,0,1
RS,Sobradinho,13,0,0,13
RS,Soledade,6,0,0,6
RS,Tapes,84,37,0,121
RS,Taquara,14,1,0,15
RS,Taquari,89,54,0,143
RS,Tavares,143,64,0,207
RS,Terra de Areia,50,32,0,82
RS,Teutônia,5,0,0,5
RS,Tiradentes do Sul,31,16,0,47
RS,Torres,296,70,0,366
RS,Tramandaí,388,81,0,469
RS,Três Arroios,1,0,0,1
RS,Três Cachoeiras,10,11,0,21
RS,Três Coroas,1,0,0,1
RS,Três de Maio,4,0,0,4
RS,Três Forquilhas,2,0,0,2
RS,Três Palmeiras,1,0,0,1
RS,Três Passos,13,4,0,17
RS,Triunfo,72,16,0,88
RS,Tucunduva,2,0,0,2
RS,Tunas,16,1,0,17
RS,Tupanciretã,2,1,0,3
RS,Tupandi,1,0,0,1
RS,Tuparendi,1,1,0,2
RS,Uruguaiana,288,157,0,445
RS,Vacaria,3,0,0,3
RS,Vale Verde,1,0,0,1
RS,Venâncio Aires,24,1,0,25
RS,Vera Cruz,7,1,0,8
RS,Veranópolis,1,0,0,1
RS,Viadutos,3,0,0,3
RS,Viamão,94,13,2,109
RS,Vicente Dutra,51,19,0,70
RS,Victor Graeff,1,0,0,1
RS,Xangri-lá,91,11,0,102
SC,Abdon Batista,254,107,1,362
SC,Abelardo Luz,2,0,0,2
SC,Agrolândia,3,0,1,4
SC,Agronômica,3,0,0,3
SC,Águas de Chapecó,82,46,1,129
SC,Águas Frias,2,0,0,2
SC,Anita Garibaldi,88,3,1,92
SC,Antônio Carlos,3,0,0,3
SC,Araquari,109,53,6,168
SC,Araranguá,140,67,3,210
SC,Arroio Trinta,18,21,0,39
SC,Aurora,5,0,0,5
SC,Balneário Arroio do Silva,112,90,4,206
SC,Balneário Barra do Sul,270,151,28,449
SC,Balneário Camboriú,150,60,18,228
SC,Balneário Gaivota,186,169,8,363
SC,Balneário Piçarras,43,18,12,73
SC,Balneário Rincão,565,669,11,1245
SC,Barra Velha,145,61,13,219
SC,Biguaçu,179,38,10,227
SC,Blumenau,14,0,0,14
SC,Bombinhas,615,234,34,883
SC,Bom Jesus,1,0,0,1
SC,Bom Retiro,2,0,0,2
SC,Brunópolis,19,0,0,19
SC,Brusque,3,0,0,3
SC,Caibi,25,13,1,39
SC,Camboriú,11,6,1,18
SC,Campo Belo do Sul,15,2,0,17
SC,Campos Novos,33,4,0,37
SC,Canelinha,4,1,0,5
SC,Canoinhas,6,0,0,6
SC,Capão Alto,1,0,0,1
SC,Capinzal,47,6,1,54
SC,Capivari de Baixo,2,1,0,3
SC,Catanduvas,1,0,0,1
SC,Caxambu do Sul,44,9,0,53
SC,Celso Ramos,27,3,1,31
SC,Cerro Negro,18,1,0,19
SC,Chapecó,87,33,1,121
SC,Concórdia,195,41,1,237
SC,Cordilheira Alta,1,1,0,2
SC,Coronel Freitas,20,3,1,24
SC,Correia Pinto,6,0,0,6
SC,Criciúma,47,4,4,55
SC,Curitibanos,106,4,1,111
SC,Erval Velho,20,1,0,21
SC,Faxinal dos Guedes,3,0,0,3
SC,Florianópolis,5255,2854,98,8207
SC,Formosa do Sul,1,2,0,3
SC,Forquilhinha,14,3,0,17
SC,Fraiburgo,21,0,0,21
SC,Garopaba,686,474,10,1170
SC,Garuva,39,11,1,51
SC,Gaspar,3,0,0,3
SC,Governador Celso Ramos,1501,763,33,2297
SC,Gravatal,2,0,0,2
SC,Guaramirim,7,2,0,9
SC,Guatambú,4,0,0,4
SC,Herval d`Oeste,105,6,2,113
SC,Ibicaré,4,1,0,5
SC,Ibirama,5,0,0,5
SC,Içara,95,40,6,141
SC,Ilhota,15,1,0,16
SC,Imaruí,264,275,10,549
SC,Imbituba,895,645,18,1558
SC,Imbuia,3,1,0,4
SC,Indaial,9,1,0,10
SC,Ipira,59,1,0,60
SC,Iporã do Oeste,3,0,0,3
SC,Ipuaçu,10,0,0,10
SC,Ipumirim,2,5,1,8
SC,Irani,6,2,0,8
SC,Irati,1,0,0,1
SC,Itá,61,10,0,71
SC,Itajaí,217,9,15,241
SC,Itapema,174,28,16,218
SC,Itapiranga,72,22,0,94
SC,Itapoá,256,208,33,497
SC,Ituporanga,3,0,0,3
SC,Jaborá,6,0,0,6
SC,Jacinto Machado,1,0,0,1
SC,Jaguaruna,380,368,7,755
SC,Jaraguá do Sul,6,0,0,6
SC,Joaçaba,64,8,0,72
SC,Joinville,769,233,21,1023
SC,Lacerdópolis,9,0,0,9
SC,Lages,212,4,14,230
SC,Laguna,2129,2632,51,4812
SC,Laurentino,3,0,0,3
SC,Lauro Muller,0,1,0,1
SC,Lindóia do Sul,6,0,0,6
SC,Lontras,2,0,0,2
SC,Maracajá,3,2,0,5
SC,Maravilha,2,0,0,2
SC,Massaranduba,1,0,1,2
SC,Meleiro,2,0,0,2
SC,Mondaí,37,9,0,46
SC,Monte Carlo,2,0,1,3
SC,Morro da Fumaça,2,0,0,2
SC,Morro Grande,3,1,0,4
SC,Navegantes,1404,56,15,1475
SC,Nova Erechim,4,3,0,7
SC,Nova Itaberaba,7,4,0,11
SC,Nova Veneza,4,0,0,4
SC,Orleans,2,0,0,2
SC,Otacílio Costa,7,0,1,8
SC,Ouro,6,0,0,6
SC,Palhoça,381,91,19,491
SC,Palmitos,42,10,0,52
SC,Passo de Torres,507,310,7,824
SC,Passos Maia,0,1,0,1
SC,Paulo Lopes,8,19,0,27
SC,Penha,1091,612,58,1761
SC,Peritiba,57,3,1,61
SC,Pinhalzinho,4,0,0,4
SC,Pinheiro Preto,9,0,0,9
SC,Piratuba,67,9,0,76
SC,Planalto Alegre,3,2,0,5
SC,Ponte Alta,6,0,0,6
SC,Ponte Alta do Norte,10,0,0,10
SC,Porto Belo,535,249,37,821
SC,Porto União,1,0,0,1
SC,Praia Grande,1,0,0,1
SC,Presidente Castello Branco,13,0,0,13
SC,Quilombo,2,1,0,3
SC,Rancho Queimado,0,1,0,1
SC,Rio das Antas,1,2,0,3
SC,Rio do Oeste,1,0,0,1
SC,Rio do Sul,2,0,0,2
SC,Riqueza,4,1,0,5
SC,Sangão,1,2,0,3
SC,Santa Cecília,20,1,1,22
SC,Santa Helena,0,1,0,1
SC,Santa Rosa do Sul,25,8,0,33
SC,Santo Amaro da Imperatriz,2,1,0,3
SC,São Carlos,205,88,2,295
SC,São Cristovão do Sul,2,0,0,2
SC,São Domingos,8,0,0,8
SC,São Francisco do Sul,570,294,24,888
SC,São João Batista,0,1,0,1
SC,São João do Sul,44,25,0,69
SC,São Joaquim,2,0,0,2
SC,São José,183,29,10,222
SC,São José do Cerrito,123,27,1,151
SC,São Lourenço do Oeste,2,0,0,2
SC,São Miguel do Oeste,3,1,0,4
SC,Saudades,2,2,0,4
SC,Seara,94,7,0,101
SC,Siderópolis,2,0,0,2
SC,Sombrio,104,52,1,157
SC,Tangará,8,0,0,8
SC,Tijucas,244,185,10,439
SC,Timbó Grande,18,0,0,18
SC,Três Barras,1,0,0,1
SC,Treze Tílias,10,1,0,11
SC,Tubarão,19,1,0,20
SC,Tunápolis,0,1,0,1
SC,Turvo,1,0,0,1
SC,Urubici,1,0,0,1
SC,Vargem,60,9,2,71
SC,Videira,60,2,1,63
SC,Xanxerê,59,0,1,60
SC,Xavantina,6,0,0,6
SC,Xaxim,1,1,0,2
SE,Amparo de São Francisco,298,387,6,691
SE,Aquidabã,2,2,0,4
SE,Aracaju,1100,2259,10,3369
SE,Arauá,0,1,0,1
SE,Areia Branca,4,3,1,8
SE,Barra dos Coqueiros,366,580,2,948
SE,Boquim,2,2,0,4
SE,Brejo Grande,963,942,7,1912
SE,Campo do Brito,3,0,0,3
SE,Canhoba,106,125,1,232
SE,Canindé de São Francisco,108,209,1,318
SE,Capela,1,0,0,1
SE,Carira,0,1,0,1
SE,Carmópolis,36,199,3,238
SE,Cedro de São João,240,199,5,444
SE,Cristinápolis,1,2,0,3
SE,Cumbe,3,4,0,7
SE,Divina Pastora,2,2,0,4
SE,Estância,370,826,12,1208
SE,Feira Nova,2,0,0,2
SE,Gararu,559,523,6,1088
SE,General Maynard,32,144,0,176
SE,Gracho Cardoso,52,40,0,92
SE,Ilha das Flores,860,1075,16,1951
SE,Indiaroba,574,941,3,1518
SE,Itabaiana,20,6,0,26
SE,Itabaianinha,0,1,0,1
SE,Itabi,6,10,0,16
SE,Itaporanga d`Ajuda,121,265,0,386
SE,Japaratuba,96,226,1,323
SE,Japoatã,0,11,0,11
SE,Lagarto,1,2,0,3
SE,Laranjeiras,152,1054,17,1223
SE,Macambira,0,2,0,2
SE,Malhada dos Bois,0,3,0,3
SE,Malhador,1,1,0,2
SE,Maruim,206,1196,10,1412
SE,Moita Bonita,0,1,0,1
SE,Monte Alegre de Sergipe,2,0,0,2
SE,Muribeca,1,2,0,3
SE,Neópolis,370,437,7,814
SE,Nossa Senhora das Dores,3,0,0,3
SE,Nossa Senhora de Lourdes,160,152,3,315
SE,Nossa Senhora do Socorro,430,1340,17,1787
SE,Pacatuba,673,1215,12,1900
SE,Pedrinhas,1,0,0,1
SE,Pirambu,779,1280,5,2064
SE,Poço Redondo,234,282,2,518
SE,Porto da Folha,808,992,8,1808
SE,Propriá,169,76,1,246
SE,Riachuelo,16,23,0,39
SE,Rosário do Catete,1,2,0,3
SE,Salgado,0,1,0,1
SE,Santa Luzia do Itanhy,375,593,1,969
SE,Santana do São Francisco,315,526,24,865
SE,Santo Amaro das Brotas,141,735,0,876
SE,São Cristóvão,617,1490,2,2109
SE,São Francisco,6,1,0,7
SE,São Miguel do Aleixo,1,1,0,2
SE,Telha,86,76,3,165
SE,Umbaúba,0,1,0,1
SP,Adamantina,56,13,0,69
SP,Adolfo,27,7,0,34
SP,Aguaí,5,0,1,6
SP,Águas de Santa Bárbara,1,0,0,1
SP,Agudos,2,0,0,2
SP,Alfredo Marcondes,3,1,0,4
SP,Altair,5,1,0,6
SP,Altinópolis,16,3,0,19
SP,Alto Alegre,4,1,0,5
SP,Alumínio,3,0,0,3
SP,Álvares Florence,2,0,0,2
SP,Álvares Machado,3,2,0,5
SP,Americana,73,7,1,81
SP,Américo Brasiliense,8,1,0,9
SP,Américo de Campos,2,0,0,2
SP,Amparo,2,0,1,3
SP,Andradina,43,19,0,62
SP,Angatuba,26,17,0,43
SP,Anhembi,108,84,0,192
SP,Anhumas,2,1,0,3
SP,Aparecida,31,13,0,44
SP,Aparecida d`Oeste,31,4,0,35
SP,Araçariguama,1,1,0,2
SP,Araçatuba,332,64,12,408
SP,Aramina,7,6,0,13
SP,Arandu,2,1,0,3
SP,Araraquara,90,10,1,101
SP,Araras,42,5,0,47
SP,Arealva,22,9,0,31
SP,Areias,6,1,0,7
SP,Areiópolis,2,0,0,2
SP,Ariranha,3,0,0,3
SP,Artur Nogueira,3,1,0,4
SP,Aspásia,12,2,0,14
SP,Assis,130,23,1,154
SP,Atibaia,8,1,0,9
SP,Auriflama,17,4,0,21
SP,Avanhandava,6,1,0,7
SP,Avaré,36,2,0,38
SP,Bady Bassitt,14,1,0,15
SP,Bálsamo,22,4,0,26
SP,Barão de Antonina,10,4,0,14
SP,Barbosa,73,19,1,93
SP,Bariri,135,22,1,158
SP,Barra Bonita,113,16,10,139
SP,Barretos,92,12,3,107
SP,Barrinha,16,0,0,16
SP,Bastos,7,0,0,7
SP,Batatais,8,1,0,9
SP,Bauru,115,19,1,135
SP,Bebedouro,74,3,0,77
SP,Bento de Abreu,0,1,0,1
SP,Bernardino de Campos,8,0,0,8
SP,Bertioga,166,52,4,222
SP,Bilac,2,0,0,2
SP,Birigui,156,26,6,188
SP,Biritiba-Mirim,7,1,0,8
SP,Boa Esperança do Sul,9,0,0,9
SP,Bocaina,2,0,0,2
SP,Bofete,1,0,0,1
SP,Boituva,3,1,0,4
SP,Bom Sucesso de Itararé,1,0,0,1
SP,Boracéia,8,2,0,10
SP,Borborema,144,44,3,191
SP,Botucatu,177,74,1,252
SP,Bragança Paulista,1,0,0,1
SP,Braúna,7,1,0,8
SP,Brejo Alegre,1,0,0,1
SP,Brodowski,25,0,0,25
SP,Brotas,6,2,0,8
SP,Buri,2,2,0,4
SP,Buritama,29,8,0,37
SP,Buritizal,3,2,0,5
SP,Caçapava,3,2,0,5
SP,Cachoeira Paulista,7,2,0,9
SP,Caconde,25,2,0,27
SP,Cafelândia,44,10,0,54
SP,Caieiras,1,1,0,2
SP,Caiuá,9,4,0,13
SP,Cajamar,4,0,0,4
SP,Cajati,1,0,0,1
SP,Cajobi,5,2,0,7
SP,Cajuru,5,0,0,5
SP,Campina do Monte Alegre,32,22,0,54
SP,Campinas,59,15,0,74
SP,Campo Limpo Paulista,1,0,0,1
SP,Campos Novos Paulista,1,0,0,1
SP,Cananéia,302,101,6,409
SP,Cândido Mota,83,29,0,112
SP,Cândido Rodrigues,3,0,0,3
SP,Canitar,2,0,0,2
SP,Capivari,8,1,0,9
SP,Caraguatatuba,159,13,19,191
SP,Cardoso,99,50,0,149
SP,Casa Branca,6,0,0,6
SP,Castilho,111,92,0,203
SP,Catanduva,109,30,1,140
SP,Catiguá,3,0,0,3
SP,Cedral,5,1,1,7
SP,Cerqueira César,9,1,0,10
SP,Cerquilho,12,1,0,13
SP,Cesário Lange,1,0,0,1
SP,Charqueada,17,2,0,19
SP,Chavantes,7,0,0,7
SP,Clementina,3,0,0,3
SP,Colina,11,3,0,14
SP,Colômbia,110,31,0,141
SP,Conchal,21,2,0,23
SP,Conchas,4,1,0,5
SP,Coroados,4,1,0,5
SP,Cosmópolis,15,1,1,17
SP,Cosmorama,13,1,1,15
SP,Cotia,4,1,0,5
SP,Cravinhos,13,0,0,13
SP,Cruzália,11,1,0,12
SP,Cubatão,37,9,0,46
SP,Descalvado,79,5,0,84
SP,Diadema,20,4,0,24
SP,Dirce Reis,3,0,0,3
SP,Divinolândia,19,5,0,24
SP,Dois Córregos,19,10,0,29
SP,Dourado,5,0,0,5
SP,Dracena,112,20,1,133
SP,Duartina,1,0,0,1
SP,Dumont,1,0,0,1
SP,Eldorado,1,0,0,1
SP,Elisiário,1,1,0,2
SP,Embu das Artes,1,1,0,2
SP,Embu-Guaçu,1,0,0,1
SP,Emilianópolis,24,2,0,26
SP,Engenheiro Coelho,2,0,0,2
SP,Espírito Santo do Pinhal,1,0,0,1
SP,Estrela d`Oeste,7,1,0,8
SP,Euclides da Cunha Paulista,30,8,0,38
SP,Fartura,29,0,0,29
SP,Fernandópolis,35,3,0,38
SP,Fernando Prestes,2,2,0,4
SP,Ferraz de Vasconcelos,5,0,0,5
SP,Flora Rica,3,0,0,3
SP,Floreal,2,0,0,2
SP,Flórida Paulista,3,4,0,7
SP,Florínia,23,7,0,30
SP,Franca,257,32,3,292
SP,Francisco Morato,1,0,0,1
SP,Gabriel Monteiro,2,0,1,3
SP,Gália,1,0,0,1
SP,Garça,1,0,0,1
SP,Gastão Vidigal,2,0,0,2
SP,General Salgado,4,1,0,5
SP,Getulina,5,2,0,7
SP,Glicério,8,1,0,9
SP,Guaiçara,24,18,0,42
SP,Guaimbê,5,0,0,5
SP,Guaíra,25,1,0,26
SP,Guapiaçu,18,0,0,18
SP,Guará,13,1,0,14
SP,Guaraçaí,8,2,0,10
SP,Guaraci,85,48,1,134
SP,Guarani d`Oeste,1,0,0,1
SP,Guarantã,37,13,0,50
SP,Guararapes,26,0,0,26
SP,Guararema,3,1,0,4
SP,Guaratinguetá,2,0,0,2
SP,Guariba,20,3,0,23
SP,Guarujá,992,296,20,1308
SP,Guarulhos,10,2,0,12
SP,Guatapará,48,9,1,58
SP,Guzolândia,4,0,0,4
SP,Hortolândia,13,2,1,16
SP,Iacanga,54,27,1,82
SP,Ibaté,26,5,0,31
SP,Ibirá,8,1,0,9
SP,Ibirarema,0,1,0,1
SP,Ibitinga,250,71,1,322
SP,Ibiúna,5,1,0,6
SP,Icém,113,39,0,152
SP,Iepê,13,5,0,18
SP,Igaraçu do Tietê,128,32,0,160
SP,Igarapava,27,10,0,37
SP,Iguape,1089,611,47,1747
SP,Ilhabela,238,88,13,339
SP,Ilha Comprida,88,37,2,127
SP,Ilha Solteira,62,25,1,88
SP,Indaiatuba,3,1,0,4
SP,Indiaporã,4,2,0,6
SP,Inúbia Paulista,3,0,0,3
SP,Ipaussu,4,0,0,4
SP,Iperó,3,1,0,4
SP,Ipeúna,2,0,0,2
SP,Iporanga,1,0,0,1
SP,Ipuã,3,0,0,3
SP,Irapuã,53,9,0,62
SP,Irapuru,8,3,0,11
SP,Itaberá,1,0,0,1
SP,Itaí,36,7,0,43
SP,Itajobi,64,12,0,76
SP,Itaju,30,6,0,36
SP,Itanhaém,250,58,14,322
SP,Itapetininga,17,3,0,20
SP,Itapeva,3,0,0,3
SP,Itapevi,8,1,0,9
SP,Itapira,1,0,0,1
SP,Itápolis,59,7,1,67
SP,Itaporanga,19,3,0,22
SP,Itapuí,30,3,0,33
SP,Itapura,64,16,0,80
SP,Itaquaquecetuba,8,3,0,11
SP,Itararé,1,0,0,1
SP,Itariri,3,1,0,4
SP,Itatiba,1,0,0,1
SP,Itatinga,2,1,0,3
SP,Itirapina,8,1,0,9
SP,Itirapuã,2,1,0,3
SP,Itu,5,1,1,7
SP,Itupeva,6,1,0,7
SP,Ituverava,42,7,0,49
SP,Jaborandi,19,4,0,23
SP,Jaboticabal,78,3,1,82
SP,Jacareí,15,3,0,18
SP,Jaci,4,0,0,4
SP,Jaguariúna,1,0,0,1
SP,Jales,43,6,0,49
SP,Jambeiro,1,1,0,2
SP,Jandira,2,1,0,3
SP,Jardinópolis,31,3,0,34
SP,Jaú,83,6,0,89
SP,Joanópolis,6,1,0,7
SP,João Ramalho,1,0,0,1
SP,José Bonifácio,23,2,0,25
SP,Júlio Mesquita,2,0,0,2
SP,Jundiaí,12,4,0,16
SP,Junqueirópolis,21,14,1,36
SP,Laranjal Paulista,10,2,0,12
SP,Lavínia,3,1,0,4
SP,Leme,28,2,0,30
SP,Lençóis Paulista,19,4,0,23
SP,Limeira,57,8,1,66
SP,Lins,322,136,7,465
SP,Lorena,1,2,0,3
SP,Lourdes,7,0,0,7
SP,Lucélia,4,2,0,6
SP,Luís Antônio,3,1,0,4
SP,Luiziânia,1,0,0,1
SP,Lutécia,2,0,0,2
SP,Macatuba,12,2,0,14
SP,Macaubal,10,1,0,11
SP,Macedônia,2,4,0,6
SP,Magda,2,0,0,2
SP,Mairinque,1,0,0,1
SP,Mairiporã,2,0,0,2
SP,Manduri,5,0,0,5
SP,Marabá Paulista,1,0,1,2
SP,Maracaí,11,1,0,12
SP,Marapoama,12,2,0,14
SP,Mariápolis,3,0,0,3
SP,Marília,41,13,0,54
SP,Marinópolis,5,2,0,7
SP,Martinópolis,3,0,1,4
SP,Matão,37,9,3,49
SP,Mauá,14,0,0,14
SP,Mendonça,34,4,2,40
SP,Meridiano,5,0,0,5
SP,Mesópolis,27,4,4,35
SP,Miguelópolis,60,23,1,84
SP,Mineiros do Tietê,21,4,0,25
SP,Mira Estrela,66,13,2,81
SP,Mirandópolis,12,2,0,14
SP,Mirante do Paranapanema,24,7,1,32
SP,Mirassol,43,8,0,51
SP,Mirassolândia,29,3,0,32
SP,Mococa,2,0,0,2
SP,Mogi das Cruzes,68,18,0,86
SP,Mogi Guaçu,34,4,0,38
SP,Moji Mirim,34,2,0,36
SP,Mongaguá,69,13,3,85
SP,Monte Alto,15,2,0,17
SP,Monte Aprazível,11,3,0,14
SP,Monte Azul Paulista,6,1,0,7
SP,Monte Castelo,8,1,0,9
SP,Monteiro Lobato,1,0,0,1
SP,Monte Mor,3,0,0,3
SP,Morro Agudo,1,0,0,1
SP,Motuca,2,0,0,2
SP,Murutinga do Sul,4,1,0,5
SP,Narandiba,4,2,0,6
SP,Natividade da Serra,36,27,0,63
SP,Neves Paulista,2,0,0,2
SP,Nhandeara,24,5,1,30
SP,Nipoã,1,0,1,2
SP,Nova Aliança,4,1,0,5
SP,Nova Canaã Paulista,17,2,0,19
SP,Nova Europa,5,2,0,7
SP,Nova Granada,87,18,0,105
SP,Nova Guataporanga,10,2,0,12
SP,Nova Independência,5,2,0,7
SP,Novais,2,0,0,2
SP,Nova Odessa,14,0,0,14
SP,Novo Horizonte,210,76,4,290
SP,Nuporanga,2,0,0,2
SP,Óleo,1,0,0,1
SP,Olímpia,50,4,1,55
SP,Onda Verde,7,3,0,10
SP,Oriente,1,0,0,1
SP,Orindiúva,26,9,0,35
SP,Orlândia,11,1,0,12
SP,Osasco,8,0,0,8
SP,Osvaldo Cruz,16,2,1,19
SP,Ourinhos,35,7,0,42
SP,Ouroeste,19,13,0,32
SP,Ouro Verde,24,6,0,30
SP,Pacaembu,12,3,0,15
SP,Palestina,16,2,0,18
SP,Palmares Paulista,7,1,0,8
SP,Palmeira d`Oeste,9,4,0,13
SP,Palmital,19,3,1,23
SP,Panorama,368,250,3,621
SP,Paraguaçu Paulista,13,3,0,16
SP,Paraibuna,13,3,0,16
SP,Paraíso,1,0,0,1
SP,Paranapanema,128,31,1,160
SP,Paranapuã,9,0,0,9
SP,Parapuã,5,0,0,5
SP,Pariquera-Açu,2,1,0,3
SP,Parisi,6,1,0,7
SP,Patrocínio Paulista,3,0,0,3
SP,Paulicéia,148,71,3,222
SP,Paulínia,5,1,0,6
SP,Paulo de Faria,99,31,0,130
SP,Pederneiras,71,22,0,93
SP,Pedranópolis,3,0,0,3
SP,Pedregulho,17,0,0,17
SP,Pedreira,2,0,0,2
SP,Pedrinhas Paulista,17,6,0,23
SP,Pedro de Toledo,3,0,0,3
SP,Penápolis,210,25,3,238
SP,Pereira Barreto,96,41,0,137
SP,Pereiras,2,0,0,2
SP,Peruíbe,259,116,8,383
SP,Piedade,0,1,0,1
SP,Pindamonhangaba,28,20,1,49
SP,Pindorama,9,5,3,17
SP,Piquerobi,1,0,0,1
SP,Piracaia,7,0,1,8
SP,Piracicaba,208,27,8,243
SP,Piraju,46,5,0,51
SP,Pirajuí,7,3,0,10
SP,Pirangi,1,0,0,1
SP,Pirapozinho,1,0,0,1
SP,Pirassununga,110,3,3,116
SP,Pitangueiras,30,2,0,32
SP,Planalto,7,0,0,7
SP,Poá,3,2,0,5
SP,Poloni,5,0,0,5
SP,Pompéia,7,0,0,7
SP,Pongaí,8,3,1,12
SP,Pontal,25,2,0,27
SP,Pontes Gestal,11,3,0,14
SP,Populina,24,2,0,26
SP,Porto Feliz,30,2,0,32
SP,Porto Ferreira,83,13,0,96
SP,Potim,17,10,0,27
SP,Potirendaba,40,6,1,47
SP,Pradópolis,1,1,0,2
SP,Praia Grande,156,30,0,186
SP,Presidente Bernardes,7,0,0,7
SP,Presidente Epitácio,564,197,9,770
SP,Presidente Prudente,48,10,0,58
SP,Presidente Venceslau,17,5,2,24
SP,Promissão,126,59,0,185
SP,Quatá,7,2,0,9
SP,Quintana,2,0,0,2
SP,Rancharia,6,5,0,11
SP,Redenção da Serra,8,6,0,14
SP,Regente Feijó,2,0,0,2
SP,Reginópolis,10,0,1,11
SP,Registro,19,5,0,24
SP,Restinga,1,0,0,1
SP,Ribeira,54,6,0,60
SP,Ribeirão do Sul,4,1,0,5
SP,Ribeirão Pires,14,1,1,16
SP,Ribeirão Preto,360,58,1,419
SP,Rifaina,30,5,1,36
SP,Rincão,15,1,0,16
SP,Rio Claro,43,8,0,51
SP,Rio das Pedras,2,0,0,2
SP,Riolândia,51,14,0,65
SP,Rosana,319,146,4,469
SP,Roseira,1,0,0,1
SP,Rubiácea,3,0,0,3
SP,Rubinéia,72,18,0,90
SP,Sabino,109,75,3,187
SP,Sagres,1,0,0,1
SP,Sales,54,14,0,68
SP,Salesópolis,24,6,2,32
SP,Salmourão,4,0,0,4
SP,Saltinho,7,2,0,9
SP,Salto,3,0,0,3
SP,Salto Grande,43,22,0,65
SP,Sandovalina,2,1,0,3
SP,Santa Albertina,42,7,0,49
SP,Santa Bárbara d`Oeste,47,1,1,49
SP,Santa Branca,20,4,0,24
SP,Santa Clara d`Oeste,41,7,1,49
SP,Santa Cruz da Conceição,3,0,0,3
SP,Santa Cruz das Palmeiras,13,0,0,13
SP,Santa Cruz do Rio Pardo,9,0,0,9
SP,Santa Fé do Sul,191,40,1,232
SP,Santa Isabel,9,2,0,11
SP,Santa Maria da Serra,100,64,1,165
SP,Santa Mercedes,18,4,0,22
SP,Santana da Ponte Pensa,6,0,0,6
SP,Santa Rita d`Oeste,23,0,0,23
SP,Santa Rita do Passa Quatro,11,0,0,11
SP,Santa Rosa de Viterbo,44,2,2,48
SP,Santo Anastácio,7,0,0,7
SP,Santo André,21,4,1,26
SP,Santo Antônio da Alegria,3,0,0,3
SP,Santo Antônio do Aracanguá,100,24,0,124
SP,Santópolis do Aguapeí,1,0,0,1
SP,Santos,318,51,23,392
SP,São Bernardo do Campo,94,35,1,130
SP,São Caetano do Sul,1,0,0,1
SP,São Carlos,110,9,0,119
SP,São Francisco,2,0,0,2
SP,São João da Boa Vista,6,1,0,7
SP,São João das Duas Pontes,1,0,0,1
SP,São João do Pau d`Alho,27,11,1,39
SP,São Joaquim da Barra,12,1,0,13
SP,São José da Bela Vista,4,0,1,5
SP,São José do Rio Pardo,17,0,0,17
SP,São José do Rio Preto,314,75,4,393
SP,São José dos Campos,24,4,3,31
SP,São Manuel,43,8,0,51
SP,São Paulo,2301,593,8,2902
SP,São Pedro,21,5,0,26
SP,São Pedro do Turvo,1,0,0,1
SP,São Sebastião,229,47,19,295
SP,São Simão,20,1,0,21
SP,São Vicente,180,45,2,227
SP,Sarutaiá,1,0,0,1
SP,Sebastianópolis do Sul,7,0,0,7
SP,Serra Azul,4,1,0,5
SP,Serrana,29,4,0,33
SP,Sertãozinho,64,7,0,71
SP,Sete Barras,1,0,0,1
SP,Severínia,8,0,0,8
SP,Sorocaba,27,4,0,31
SP,Sud Mennucci,49,10,2,61
SP,Sumaré,15,4,1,20
SP,Suzanápolis,10,4,0,14
SP,Suzano,27,3,0,30
SP,Tabapuã,4,2,0,6
SP,Tabatinga,11,2,0,13
SP,Taboão da Serra,1,1,0,2
SP,Taciba,6,2,0,8
SP,Taguaí,1,0,0,1
SP,Taiaçu,5,0,0,5
SP,Taiúva,4,0,0,4
SP,Tambaú,0,0,1,1
SP,Tanabi,33,7,0,40
SP,Tapiraí,0,1,0,1
SP,Taquaritinga,35,8,1,44
SP,Taquarituba,22,5,0,27
SP,Tarumã,1,0,0,1
SP,Tatuí,2,0,0,2
SP,Taubaté,6,1,1,8
SP,Tejupá,1,0,0,1
SP,Teodoro Sampaio,102,28,3,133
SP,Terra Roxa,37,6,0,43
SP,Timburi,10,0,0,10
SP,Torrinha,3,0,0,3
SP,Tremembé,0,2,0,2
SP,Três Fronteiras,30,2,1,33
SP,Tuiuti,1,0,0,1
SP,Tupã,14,2,0,16
SP,Tupi Paulista,62,11,0,73
SP,Turiúba,2,0,0,2
SP,Turmalina,2,0,0,2
SP,Ubarana,58,26,1,85
SP,Ubatuba,658,103,30,791
SP,Uchoa,4,0,0,4
SP,Urânia,9,3,0,12
SP,Uru,34,6,0,40
SP,Urupês,62,5,0,67
SP,Valentim Gentil,14,3,0,17
SP,Valinhos,3,0,0,3
SP,Valparaíso,9,3,0,12
SP,Vargem,12,2,0,14
SP,Vargem Grande do Sul,4,0,0,4
SP,Vargem Grande Paulista,2,0,0,2
SP,Várzea Paulista,6,2,0,8
SP,Vera Cruz,6,1,0,7
SP,Vinhedo,3,1,0,4
SP,Viradouro,51,11,0,62
SP,Votorantim,32,0,0,32
SP,Votuporanga,61,11,1,73
SP,Zacarias,2,0,0,2
TO,Abreulândia,1,0,0,1
TO,Aguiarnópolis,1,1,0,2
TO,Alvorada,0,1,0,1
TO,Ananás,9,2,1,12
TO,Angico,0,1,0,1
TO,Aparecida do Rio Negro,4,0,0,4
TO,Aragominas,62,55,0,117
TO,Araguacema,93,36,0,129
TO,Araguaçu,0,1,0,1
TO,Araguaína,12,17,0,29
TO,Araguanã,102,121,1,224
TO,Araguatins,618,504,4,1126
TO,Arapoema,3,2,0,5
TO,Arraias,14,2,0,16
TO,Augustinópolis,3,0,0,3
TO,Axixá do Tocantins,1,1,0,2
TO,Babaçulândia,131,68,1,200
TO,Barra do Ouro,63,50,0,113
TO,Barrolândia,2,2,0,4
TO,Bernardo Sayão,2,2,0,4
TO,Bom Jesus do Tocantins,4,2,0,6
TO,Brejinho de Nazaré,22,9,0,31
TO,Buriti do Tocantins,16,7,0,23
TO,Cachoeirinha,0,1,0,1
TO,Campos Lindos,1,0,0,1
TO,Carrasco Bonito,50,30,1,81
TO,Caseara,92,51,0,143
TO,Colinas do Tocantins,9,1,0,10
TO,Conceição do Tocantins,1,0,0,1
TO,Couto Magalhães,66,26,1,93
TO,Cristalândia,1,0,0,1
TO,Darcinópolis,2,1,1,4
TO,Esperantina,282,287,2,571
TO,Filadélfia,171,118,3,292
TO,Goiatins,9,4,0,13
TO,Guaraí,20,3,0,23
TO,Gurupi,0,1,1,2
TO,Ipueiras,25,12,0,37
TO,Itacajá,9,0,0,9
TO,Itaguatins,53,34,0,87
TO,Itapiratins,180,85,2,267
TO,Jaú do Tocantins,4,0,1,5
TO,Lagoa da Confusão,32,16,0,48
TO,Lagoa do Tocantins,1,1,0,2
TO,Lajeado,22,8,0,30
TO,Marianópolis do Tocantins,1,1,0,2
TO,Maurilândia do Tocantins,33,8,0,41
TO,Miracema do Tocantins,77,26,0,103
TO,Monte do Carmo,5,4,0,9
TO,Muricilândia,5,1,0,6
TO,Natividade,28,12,0,40
TO,Nova Olinda,20,14,0,34
TO,Palmas,879,443,4,1326
TO,Palmeirante,65,52,2,119
TO,Palmeiras do Tocantins,85,45,0,130
TO,Palmeirópolis,18,2,0,20
TO,Paraíso do Tocantins,0,2,0,2
TO,Paranã,53,21,2,76
TO,Pau d`Arco,135,111,1,247
TO,Pedro Afonso,44,21,0,65
TO,Peixe,75,10,0,85
TO,Pequizeiro,1,1,0,2
TO,Piraquê,0,1,0,1
TO,Pium,1,1,0,2
TO,Ponte Alta do Tocantins,1,0,0,1
TO,Porto Alegre do Tocantins,1,0,0,1
TO,Porto Nacional,108,30,0,138
TO,Praia Norte,231,146,6,383
TO,Recursolândia,1,0,0,1
TO,Riachinho,0,1,0,1
TO,Rio dos Bois,0,2,0,2
TO,Sampaio,206,301,2,509
TO,Santa Fé do Araguaia,58,39,0,97
TO,Santa Maria do Tocantins,1,1,0,2
TO,Santa Tereza do Tocantins,1,0,0,1
TO,São Bento do Tocantins,1,0,0,1
TO,São Miguel do Tocantins,59,43,1,103
TO,São Salvador do Tocantins,38,16,0,54
TO,São Sebastião do Tocantins,136,137,1,274
TO,São Valério,21,8,0,29
TO,Taguatinga,2,0,0,2
TO,Tocantínia,13,1,0,14
TO,Tocantinópolis,157,107,0,264
TO,Tupiratins,53,9,1,63
TO,Wanderlândia,0,2,0,2
TO,Xambioá,69,46,0,115
